날짜,시가,고가,저가,종가,거래량,등락률,기관합계_거래량_순매수,기타법인_거래량_순매수,개인_거래량_순매수,외국인합계_거래량_순매수,전체_거래량_순매수,기관합계_거래량_매수,기타법인_거래량_매수,개인_거래량_매수,외국인합계_거래량_매수,전체_거래량_매수,기관합계_거래량_매도,기타법인_거래량_매도,개인_거래량_매도,외국인합계_거래량_매도,전체_거래량_매도,기관합계_거래대금_순매수,기타법인_거래대금_순매수,개인_거래대금_순매수,외국인합계_거래대금_순매수,전체_거래대금_순매수,기관합계_거래대금_매수,기타법인_거래대금_매수,개인_거래대금_매수,외국인합계_거래대금_매수,전체_거래대금_매수,기관합계_거래대금_매도,기타법인_거래대금_매도,개인_거래대금_매도,외국인합계_거래대금_매도,전체_거래대금_매도
2019-01-02,566,566,555,557,47332,-1.5901060070671376,0,0,0,0,0,0,0,10731,0,10731,0,0,10731,0,10731,0,0,0,0,0,0,0,26462535,0,26462535,0,0,26462535,0,26462535
2019-01-03,563,563,555,561,109467,0.718132854578097,0,0,0,0,0,0,0,24818,0,24818,0,0,24818,0,24818,0,0,0,0,0,0,0,61248625,0,61248625,0,0,61248625,0,61248625
2019-01-04,566,566,552,556,172118,-0.8912655971479502,1521,0,-1521,0,0,1521,0,37501,0,39022,0,0,39022,0,39022,3740660,0,-3740660,0,0,3740660,0,91896960,0,95637620,0,0,95637620,0,95637620
2019-01-07,571,571,554,556,54619,0.0,0,0,0,0,0,0,0,12383,0,12383,0,0,12383,0,12383,0,0,0,0,0,0,0,30366070,0,30366070,0,0,30366070,0,30366070
2019-01-08,567,567,555,555,37019,-0.1798561151079137,30,0,-30,0,0,30,0,8363,0,8393,0,0,8393,0,8393,73650,0,-73650,0,0,73650,0,20520060,0,20593710,0,0,20593710,0,20593710
2019-01-09,564,564,555,555,160249,0.0,10,0,-10,0,0,10,0,36321,0,36331,0,0,36331,0,36331,24500,0,-24500,0,0,24500,0,89054260,0,89078760,0,0,89078760,0,89078760
2019-01-10,565,565,554,556,99587,0.18018018018018017,1900,0,-1900,0,0,1900,0,20678,0,22578,0,0,22578,0,22578,4674000,0,-4674000,0,0,4674000,0,50727415,0,55401415,0,0,55401415,0,55401415
2019-01-11,565,565,556,561,5028,0.8992805755395683,0,0,0,0,0,0,0,1140,0,1140,0,0,1140,0,1140,0,0,0,0,0,0,0,2798780,0,2798780,0,0,2798780,0,2798780
2019-01-14,569,569,555,555,45135,-1.06951871657754,32,0,-32,0,0,32,0,10201,0,10233,0,0,10233,0,10233,80480,0,-80480,0,0,80480,0,24998515,0,25078995,0,0,25078995,0,25078995
2019-01-15,557,565,555,555,80109,0.0,100,0,-100,0,0,100,0,18062,0,18162,0,0,18162,0,18162,246000,0,-246000,0,0,246000,0,44286020,0,44532020,0,0,44532020,0,44532020
2019-01-16,560,560,553,559,116957,0.7207207207207207,0,0,0,0,0,0,0,26516,0,26516,0,0,26516,0,26516,0,0,0,0,0,0,0,64961180,0,64961180,0,0,64961180,0,64961180
2019-01-17,560,560,554,559,16549,0.0,0,0,0,0,0,0,0,3752,0,3752,0,0,3752,0,3752,0,0,0,0,0,0,0,9220955,0,9220955,0,0,9220955,0,9220955
2019-01-18,559,562,556,561,47341,0.35778175313059035,388,0,-388,0,0,388,0,10345,0,10733,0,0,10733,0,10733,960300,0,-960300,0,0,960300,0,25549385,0,26509685,0,0,26509685,0,26509685
2019-01-21,564,564,558,562,88110,0.17825311942959002,0,0,0,0,0,0,0,19976,0,19976,0,0,19976,0,19976,0,0,0,0,0,0,0,49476640,0,49476640,0,0,49476640,0,49476640
2019-01-22,564,564,559,562,25075,0.0,684,0,-684,0,0,684,0,5001,0,5685,0,0,5685,0,5685,1699740,0,-1699740,0,0,1699740,0,12391055,0,14090795,0,0,14090795,0,14090795
2019-01-23,563,563,555,562,159067,0.0,0,0,0,0,0,0,0,36063,0,36063,0,0,36063,0,36063,0,0,0,0,0,0,0,88439645,0,88439645,0,0,88439645,0,88439645
2019-01-24,560,560,556,559,19791,-0.5338078291814947,0,0,0,0,0,0,0,4487,0,4487,0,0,4487,0,4487,0,0,0,0,0,0,0,11043320,0,11043320,0,0,11043320,0,11043320
2019-01-25,561,561,559,559,1654,0.0,0,0,0,0,0,0,0,375,0,375,0,0,375,0,375,0,0,0,0,0,0,0,926515,0,926515,0,0,926515,0,926515
2019-01-28,561,561,555,559,138239,0.0,0,0,0,0,0,0,0,31341,0,31341,0,0,31341,0,31341,0,0,0,0,0,0,0,77282220,0,77282220,0,0,77282220,0,77282220
2019-01-29,561,561,555,557,70634,-0.35778175313059035,0,0,0,0,0,0,0,16014,0,16014,0,0,16014,0,16014,0,0,0,0,0,0,0,39344410,0,39344410,0,0,39344410,0,39344410
2019-01-30,561,561,555,555,146615,-0.3590664272890485,0,2,-2,0,0,0,2,33238,0,33240,0,0,33240,0,33240,0,4910,-4910,0,0,0,4910,81436810,0,81441720,0,0,81441720,0,81441720
2019-01-31,555,562,553,555,113843,0.0,1000,0,-1000,0,0,1000,0,24810,0,25810,0,0,25810,0,25810,2450000,0,-2450000,0,0,2450000,0,60762405,0,63212405,0,0,63212405,0,63212405
2019-02-01,553,562,552,555,171655,0.0,999,2,-1001,0,0,999,2,37916,0,38917,0,0,38917,0,38917,2446450,4890,-2451340,0,0,2446450,4890,92658420,0,95109760,0,0,95109760,0,95109760
2019-02-07,563,563,554,557,74092,0.36036036036036034,0,2,-2,0,0,0,2,16796,0,16798,0,0,16798,0,16798,0,4935,-4935,0,0,0,4935,41314710,0,41319645,0,0,41319645,0,41319645
2019-02-08,563,563,554,557,67957,0.0,0,3,-3,0,0,0,3,15404,0,15407,0,0,15407,0,15407,0,7350,-7350,0,0,0,7350,37782380,0,37789730,0,0,37789730,0,37789730
2019-02-11,557,561,552,555,98709,-0.3590664272890485,0,3,-3,0,0,0,3,22376,0,22379,0,0,22379,0,22379,0,7320,-7320,0,0,0,7320,54764995,0,54772315,0,0,54772315,0,54772315
2019-02-12,561,561,554,557,27025,0.36036036036036034,0,1,-1,0,0,0,1,6126,0,6127,0,0,6127,0,6127,0,2450,-2450,0,0,0,2450,15019980,0,15022430,0,0,15022430,0,15022430
2019-02-13,558,558,554,556,30019,-0.17953321364452424,0,3,-3,0,0,0,3,6803,0,6806,0,0,6806,0,6806,0,7365,-7365,0,0,0,7365,16707845,0,16715210,0,0,16715210,0,16715210
2019-02-14,559,559,552,557,175784,0.1798561151079137,0,0,149,-149,0,0,0,39853,0,39853,0,0,39704,149,39853,0,0,364305,-364305,0,0,0,97416355,0,97416355,0,0,97052050,364305,97416355
2019-02-15,559,559,551,556,189223,-0.17953321364452424,0,0,0,0,0,0,0,42900,0,42900,0,0,42900,0,42900,0,0,0,0,0,0,0,104604550,0,104604550,0,0,104604550,0,104604550
2019-02-18,556,556,551,555,130489,-0.1798561151079137,0,0,0,0,0,0,0,29584,0,29584,0,0,29584,0,29584,0,0,0,0,0,0,0,72109585,0,72109585,0,0,72109585,0,72109585
2019-02-19,559,559,552,556,112652,0.18018018018018017,0,0,0,0,0,0,0,25540,0,25540,0,0,25540,0,25540,0,0,0,0,0,0,0,62544330,0,62544330,0,0,62544330,0,62544330
2019-02-20,559,559,551,556,170870,0.0,418,5,-423,0,0,418,5,38316,0,38739,0,0,38739,0,38739,1024100,12175,-1036275,0,0,1024100,12175,93686445,0,94722720,0,0,94722720,0,94722720
2019-02-21,557,557,552,556,41977,0.0,0,0,0,0,0,0,0,9517,0,9517,0,0,9517,0,9517,0,0,0,0,0,0,0,23296535,0,23296535,0,0,23296535,0,23296535
2019-02-22,556,556,552,555,15989,-0.1798561151079137,0,0,0,0,0,0,0,3625,0,3625,0,0,3625,0,3625,0,0,0,0,0,0,0,8864830,0,8864830,0,0,8864830,0,8864830
2019-02-25,556,556,553,556,42934,0.18018018018018017,677,0,-677,0,0,677,0,9057,0,9734,0,0,9734,0,9734,1658650,0,-1658650,0,0,1658650,0,22176515,0,23835165,0,0,23835165,0,23835165
2019-02-26,557,557,555,555,43517,-0.1798561151079137,0,0,0,0,0,0,0,9866,0,9866,0,0,9866,0,9866,0,0,0,0,0,0,0,24176225,0,24176225,0,0,24176225,0,24176225
2019-02-27,554,556,553,556,38290,0.18018018018018017,4049,0,-4049,0,0,4049,0,4632,0,8681,0,0,8681,0,8681,9940295,0,-9940295,0,0,9940295,0,11330315,0,21270610,0,0,21270610,0,21270610
2019-02-28,556,557,554,556,24290,0.0,-195,0,195,0,0,0,0,5507,0,5507,195,0,5312,0,5507,-477750,0,477750,0,0,0,0,13497165,0,13497165,477750,0,13019415,0,13497165
2019-03-04,557,557,554,556,27933,0.0,1000,11,-1011,0,0,1000,11,5322,0,6333,0,0,6333,0,6333,2455000,27000,-2482000,0,0,2455000,27000,13061520,0,15543520,0,0,15543520,0,15543520
2019-03-05,557,557,552,555,131552,-0.1798561151079137,6112,1,-6113,0,0,6112,1,23712,0,29825,0,0,29825,0,29825,15035520,2455,-15037975,0,0,15035520,2455,57987455,0,73025430,0,0,73025430,0,73025430
2019-03-06,555,555,552,554,188994,-0.18018018018018017,5999,0,-5999,0,0,5999,1,36848,0,42848,0,1,42847,0,42848,14682550,0,-14682550,0,0,14682550,2445,89995410,0,104680405,0,2445,104677960,0,104680405
2019-03-07,557,557,555,555,2046,0.18050541516245489,0,0,0,0,0,0,0,464,0,464,0,0,464,0,464,0,0,0,0,0,0,0,1138635,0,1138635,0,0,1138635,0,1138635
2019-03-08,555,556,553,555,60489,0.0,0,1,-1,0,0,0,1,13713,0,13714,0,0,13714,0,13714,0,2450,-2450,0,0,0,2450,33548650,0,33551100,0,0,33551100,0,33551100
2019-03-11,557,557,552,554,61151,-0.18018018018018017,0,-705,705,0,0,0,0,13864,0,13864,0,705,13159,0,13864,0,-1720200,1720200,0,0,0,0,33845980,0,33845980,0,1720200,32125780,0,33845980
2019-03-12,555,555,552,555,12901,0.18050541516245489,0,0,0,0,0,0,0,2925,0,2925,0,0,2925,0,2925,0,0,0,0,0,0,0,7152720,0,7152720,0,0,7152720,0,7152720
2019-03-13,555,555,553,555,104606,0.0,-5,0,5,0,0,0,0,23716,0,23716,5,0,23711,0,23716,-12250,0,12250,0,0,0,0,57988410,0,57988410,12250,0,57976160,0,57988410
2019-03-14,557,557,553,557,61380,0.36036036036036034,2400,0,-2400,0,0,2400,0,11516,0,13916,0,0,13916,0,13916,5892000,0,-5892000,0,0,5892000,0,28170775,0,34062775,0,0,34062775,0,34062775
2019-03-15,557,557,554,556,54200,-0.17953321364452424,0,2,-2,0,0,0,2,12286,0,12288,0,0,12288,0,12288,0,4900,-4900,0,0,0,4900,30130390,0,30135290,0,0,30135290,0,30135290
2019-03-18,556,556,553,555,39163,-0.1798561151079137,0,1,-1,0,0,0,1,8878,0,8879,0,0,8879,0,8879,0,2450,-2450,0,0,0,2450,21737105,0,21739555,0,0,21739555,0,21739555
2019-03-19,556,556,553,556,181994,0.18018018018018017,0,31,-31,0,0,0,31,41230,0,41261,0,0,41261,0,41261,0,75800,-75800,0,0,0,75800,100852230,0,100928030,0,0,100928030,0,100928030
2019-03-20,555,557,555,557,27219,0.1798561151079137,0,-1000,1000,0,0,0,0,6171,0,6171,0,1000,5171,0,6171,0,-2455000,2455000,0,0,0,0,15152315,0,15152315,0,2455000,12697315,0,15152315
2019-03-21,557,557,553,556,212151,-0.17953321364452424,0,2,-2,0,0,0,2,48096,0,48098,0,0,48098,0,48098,0,4910,-4910,0,0,0,4910,117648560,0,117653470,0,0,117653470,0,117653470
2019-03-22,556,556,554,556,40769,0.0,1028,2,-1030,0,0,1028,2,8213,0,9243,0,0,9243,0,9243,2523740,4905,-2528645,0,0,2523740,4905,20147115,0,22675760,0,0,22675760,0,22675760
2019-03-25,556,557,554,556,20942,0.0,1,2,-3,0,0,1,2,4745,0,4748,0,0,4748,0,4748,2450,4905,-7355,0,0,2450,4905,11627355,0,11634710,0,0,11634710,0,11634710
2019-03-26,557,557,555,557,26332,0.1798561151079137,0,0,0,0,0,0,0,5970,0,5970,0,0,5970,0,5970,0,0,0,0,0,0,0,14659455,0,14659455,0,0,14659455,0,14659455
2019-03-27,557,557,554,557,220333,0.0,0,0,0,0,0,0,0,49953,0,49953,0,0,49953,0,49953,0,0,0,0,0,0,0,122871130,0,122871130,0,0,122871130,0,122871130
2019-03-28,550,550,543,545,993213,-2.154398563734291,1,29893,-29894,0,0,1,29893,195283,0,225177,0,0,225177,0,225177,2420,71743200,-71745620,0,0,2420,71743200,469990120,0,541735740,0,0,541735740,0,541735740
2019-03-29,543,545,543,545,355564,0.0,2,20000,-20002,0,0,2,20000,60610,0,80612,0,0,80612,0,80612,4800,48000000,-48004800,0,0,4800,48000000,145478810,0,193483610,0,0,193483610,0,193483610
2019-04-01,540,540,528,528,1750258,-3.1192660550458715,2,62595,-62626,29,0,2,62595,334185,29,396811,0,0,396811,0,396811,4700,146949300,-147023165,69165,0,4700,146949300,785160015,69165,932183180,0,0,932183180,0,932183180
2019-04-02,528,531,524,528,631707,0.0,0,997,2444,-3441,0,0,997,142162,59,143218,0,0,139718,3500,143218,0,2313045,5669485,-7982530,0,0,2313045,330351675,137470,332802190,0,0,324682190,8120000,332802190
2019-04-03,528,531,527,527,218789,-0.1893939393939394,0,2,-2,0,0,0,2,49601,0,49603,0,0,49603,0,49603,0,4655,-4655,0,0,0,4655,115466900,0,115471555,0,0,115471555,0,115471555
2019-04-04,526,526,520,520,818289,-1.3282732447817838,1,26414,-26415,0,0,1,26414,159104,0,185519,0,0,185519,0,185519,2310,60884325,-60886635,0,0,2310,60884325,367265360,0,428151995,0,0,428151995,0,428151995
2019-04-05,518,522,517,520,679997,0.0,-5,8810,-8805,0,0,0,8810,145356,0,154166,5,0,154161,0,154166,-11450,20174950,-20163500,0,0,0,20174950,333012090,0,353187040,11450,0,353175590,0,353187040
2019-04-08,520,520,518,520,208331,0.0,0,0,0,0,0,0,0,47232,0,47232,0,0,47232,0,47232,0,0,0,0,0,0,0,108276195,0,108276195,0,0,108276195,0,108276195
2019-04-09,521,521,519,521,149103,0.19230769230769232,0,0,0,0,0,0,0,33804,0,33804,0,0,33804,0,33804,0,0,0,0,0,0,0,77607905,0,77607905,0,0,77607905,0,77607905
2019-04-10,525,525,518,521,102370,0.0,500,0,-500,0,0,500,0,22709,0,23209,0,0,23209,0,23209,1150000,0,-1150000,0,0,1150000,0,52103720,0,53253720,0,0,53253720,0,53253720
2019-04-11,522,527,520,525,132659,0.7677543186180422,0,0,0,0,0,0,0,30076,0,30076,0,0,30076,0,30076,0,0,0,0,0,0,0,69638615,0,69638615,0,0,69638615,0,69638615
2019-04-12,529,529,525,525,124349,0.0,500,0,-500,0,0,500,0,27692,0,28192,0,0,28192,0,28192,1167500,0,-1167500,0,0,1167500,0,64394260,0,65561760,0,0,65561760,0,65561760
2019-04-15,525,525,522,524,142782,-0.19047619047619047,0,0,0,0,0,0,0,32371,0,32371,0,0,32371,0,32371,0,0,0,0,0,0,0,74962650,0,74962650,0,0,74962650,0,74962650
2019-04-16,523,523,518,520,560371,-0.7633587786259541,-1000,0,1000,0,0,0,0,127045,0,127045,1000,0,126045,0,127045,-2295000,0,2295000,0,0,0,0,291642525,0,291642525,2295000,0,289347525,0,291642525
2019-04-17,522,522,512,512,506453,-1.5384615384615385,0,0,0,0,0,0,0,114821,0,114821,0,0,114821,0,114821,0,0,0,0,0,0,0,261291130,0,261291130,0,0,261291130,0,261291130
2019-04-18,511,512,505,505,1129176,-1.3671875,0,0,-5,5,0,0,0,255997,5,256002,0,0,256002,0,256002,0,0,-11300,11300,0,0,0,573849925,11300,573861225,0,0,573861225,0,573861225
2019-04-19,504,508,502,508,546737,0.594059405940594,0,0,0,0,0,0,0,123954,0,123954,0,0,123954,0,123954,0,0,0,0,0,0,0,275695440,0,275695440,0,0,275695440,0,275695440
2019-04-22,509,513,505,508,540293,0.0,1316,1,-1317,0,0,1316,1,121176,0,122493,0,0,122493,0,122493,2961000,2250,-2963250,0,0,2961000,2250,272071395,0,275034645,0,0,275034645,0,275034645
2019-04-23,508,512,508,512,29821,0.7874015748031495,0,1,-1,0,0,0,1,6760,0,6761,0,0,6761,0,6761,0,2250,-2250,0,0,0,2250,15213065,0,15215315,0,0,15215315,0,15215315
2019-04-24,511,514,509,514,35462,0.390625,0,2,-2,0,0,0,2,8038,0,8040,0,0,8040,0,8040,0,4500,-4500,0,0,0,4500,18118460,0,18122960,0,0,18122960,0,18122960
2019-04-25,514,514,511,513,87228,-0.19455252918287938,0,2,-2,0,0,0,2,19774,0,19776,0,0,19776,0,19776,0,4520,-4520,0,0,0,4520,44697020,0,44701540,0,0,44701540,0,44701540
2019-04-26,517,517,512,515,65474,0.3898635477582846,0,1,-1,0,0,0,1,14843,0,14844,0,0,14844,0,14844,0,2265,-2265,0,0,0,2265,33769290,0,33771555,0,0,33771555,0,33771555
2019-04-29,515,520,515,519,133100,0.7766990291262136,0,0,0,0,0,0,0,30176,0,30176,0,0,30176,0,30176,0,0,0,0,0,0,0,69013385,0,69013385,0,0,69013385,0,69013385
2019-04-30,519,520,514,518,43764,-0.1926782273603083,0,0,1,-1,0,0,0,9922,0,9922,0,0,9921,1,9922,0,0,2290,-2290,0,0,0,22544190,0,22544190,0,0,22541900,2290,22544190
2019-05-02,517,519,513,516,82111,-0.3861003861003861,0,0,0,0,0,0,0,18616,0,18616,0,0,18616,0,18616,0,0,0,0,0,0,0,42346130,0,42346130,0,0,42346130,0,42346130
2019-05-03,518,518,512,515,167650,-0.1937984496124031,0,0,0,0,0,0,0,38009,0,38009,0,0,38009,0,38009,0,0,0,0,0,0,0,86237890,0,86237890,0,0,86237890,0,86237890
2019-05-07,519,519,513,516,42246,0.1941747572815534,0,1,-1,0,0,0,1,9577,0,9578,0,0,9578,0,9578,0,2270,-2270,0,0,0,2270,21767360,0,21769630,0,0,21769630,0,21769630
2019-05-08,520,520,514,519,88264,0.5813953488372093,0,0,0,0,0,0,0,20011,0,20011,0,0,20011,0,20011,0,0,0,0,0,0,0,45543765,0,45543765,0,0,45543765,0,45543765
2019-05-09,517,520,516,520,250132,0.1926782273603083,0,1,-1,0,0,0,1,56708,0,56709,0,0,56709,0,56709,0,2285,-2285,0,0,0,2285,129663750,0,129666035,0,0,129666035,0,129666035
2019-05-10,519,520,518,518,226640,-0.38461538461538464,0,1,51,-52,0,0,1,51382,0,51383,0,0,51331,52,51383,0,2290,117050,-119340,0,0,2290,117615045,0,117617335,0,0,117497995,119340,117617335
2019-05-13,517,521,517,519,76580,0.19305019305019305,0,1,-1001,1000,0,0,1,16361,1000,17362,0,0,17362,0,17362,0,2290,-2292290,2290000,0,0,2290,37459905,2290000,39752195,0,0,39752195,0,39752195
2019-05-14,518,520,517,520,66673,0.1926782273603083,0,1,-1001,1000,0,0,1,14115,1000,15116,0,0,15116,0,15116,0,2285,-2292285,2290000,0,0,2285,32315100,2290000,34607385,0,0,34607385,0,34607385
2019-05-15,520,520,518,520,676750,0.0,500,-132542,130656,1386,0,500,1,151529,1400,153430,0,132543,20873,14,153430,1145005,-302195750,297869875,3180870,0,1145005,2290,345694185,3213000,350054480,0,302198040,47824310,32130,350054480
2019-05-16,518,521,518,520,54477,0.0,0,0,2700,-2700,0,0,0,12051,300,12351,0,0,9351,3000,12351,0,0,6196500,-6196500,0,0,0,27627115,688500,28315615,0,0,21430615,6885000,28315615
2019-05-17,520,520,516,520,135751,0.0,0,3,4899,-4902,0,0,3,30774,0,30777,0,0,25875,4902,30777,0,6860,11243230,-11250090,0,0,6860,70398595,0,70405455,0,0,59155365,11250090,70405455
2019-05-20,520,520,517,519,97897,-0.19230769230769232,0,2,-302,300,0,0,2,21893,300,22195,0,0,22195,0,22195,0,4575,-691575,687000,0,0,4575,50101400,687000,50792975,0,0,50792975,0,50792975
2019-05-21,518,520,517,520,53935,0.1926782273603083,0,0,-400,400,0,0,0,11828,400,12228,0,0,12228,0,12228,0,0,-916000,916000,0,0,0,27060765,916000,27976765,0,0,27976765,0,27976765
2019-05-22,520,520,516,516,308439,-0.7692307692307693,0,1,-801,800,0,0,1,69127,800,69928,0,0,69928,0,69928,0,2280,-1828280,1826000,0,0,2280,157650035,1826000,159478315,0,0,159478315,0,159478315
2019-05-23,516,519,516,516,82473,0.0,0,1,-401,400,0,0,1,18297,400,18698,0,0,18698,0,18698,0,2285,-916285,914000,0,0,2285,41728755,914000,42645040,0,0,42645040,0,42645040
2019-05-24,517,517,514,514,66281,-0.3875968992248062,-4000,0,5248,-1248,0,0,0,15027,0,15027,4000,0,9779,1248,15027,-9080000,0,11925440,-2845440,0,0,0,34189425,0,34189425,9080000,0,22263985,2845440,34189425
2019-05-27,520,520,514,518,37196,0.7782101167315175,0,0,850,-850,0,0,0,8433,0,8433,0,0,7583,850,8433,0,0,1929500,-1929500,0,0,0,19163410,0,19163410,0,0,17233910,1929500,19163410
2019-05-28,519,519,514,518,83024,0.0,0,0,0,0,0,0,0,18823,0,18823,0,0,18823,0,18823,0,0,0,0,0,0,0,42781760,0,42781760,0,0,42781760,0,42781760
2019-05-29,517,520,516,516,248725,-0.3861003861003861,0,1,9,-10,0,0,1,56389,0,56390,0,0,56380,10,56390,0,2280,20570,-22850,0,0,2280,128601970,0,128604250,0,0,128581400,22850,128604250
2019-05-30,520,520,513,516,225595,0.0,0,0,0,0,0,0,0,51146,0,51146,0,0,51146,0,51146,0,0,0,0,0,0,0,116249005,0,116249005,0,0,116249005,0,116249005
2019-05-31,521,521,517,519,11287,0.5813953488372093,0,0,2,-2,0,0,0,2559,0,2559,0,0,2557,2,2559,0,0,4600,-4600,0,0,0,5857915,0,5857915,0,0,5853315,4600,5857915
2019-06-03,520,520,512,516,60110,-0.5780346820809248,0,1,-3,2,0,0,1,13625,2,13628,0,0,13628,0,13628,0,2275,-6805,4530,0,0,2275,30948995,4530,30955800,0,0,30955800,0,30955800
2019-06-04,519,519,516,516,163102,0.0,0,1,-1,0,0,0,1,36977,0,36978,0,0,36978,0,36978,0,2280,-2280,0,0,0,2280,84347880,0,84350160,0,0,84350160,0,84350160
2019-06-05,520,520,516,519,39922,0.5813953488372093,0,0,0,0,0,0,0,9051,0,9051,0,0,9051,0,9051,0,0,0,0,0,0,0,20636555,0,20636555,0,0,20636555,0,20636555
2019-06-07,519,519,514,519,134481,0.0,0,2,-2,0,0,0,2,30487,0,30489,0,0,30489,0,30489,0,4565,-4565,0,0,0,4565,69498950,0,69503515,0,0,69503515,0,69503515
2019-06-10,520,520,516,516,157567,-0.5780346820809248,0,2,-2,0,0,0,2,35721,0,35723,0,0,35723,0,35723,0,4570,-4570,0,0,0,4570,81443900,0,81448470,0,0,81448470,0,81448470
2019-06-11,521,521,516,518,66594,0.3875968992248062,0,0,1,-1,0,0,0,15098,0,15098,0,0,15097,1,15098,0,0,2300,-2300,0,0,0,34479750,0,34479750,0,0,34477450,2300,34479750
2019-06-12,521,521,514,519,220963,0.19305019305019305,0,1,-3,2,0,0,1,50092,3,50096,0,0,50095,1,50096,0,2280,-6790,4510,0,0,2280,113945440,6810,113954530,0,0,113952230,2300,113954530
2019-06-13,520,521,516,518,28705,-0.1926782273603083,0,1,0,-1,0,0,1,6507,0,6508,0,0,6507,1,6508,0,2290,5,-2295,0,0,2290,14881045,0,14883335,0,0,14881040,2295,14883335
2019-06-14,519,519,515,518,54230,0.0,0,0,0,0,0,0,0,12295,0,12295,0,0,12295,0,12295,0,0,0,0,0,0,0,28004295,0,28004295,0,0,28004295,0,28004295
2019-06-17,515,519,515,518,76474,0.0,0,0,0,0,0,0,0,17338,0,17338,0,0,17338,0,17338,0,0,0,0,0,0,0,39529685,0,39529685,0,0,39529685,0,39529685
2019-06-18,515,515,509,514,400289,-0.7722007722007722,0,0,12000,-12000,0,0,0,90752,0,90752,0,0,78752,12000,90752,0,0,27000000,-27000000,0,0,0,204924520,0,204924520,0,0,177924520,27000000,204924520
2019-06-19,519,519,514,514,125937,0.0,0,0,0,0,0,0,0,28548,4,28552,0,0,28548,4,28552,0,0,100,-100,0,0,0,64920020,9080,64929100,0,0,64919920,9180,64929100
2019-06-20,518,518,512,514,572527,0.0,0,0,-3,3,0,0,0,129795,6,129801,0,0,129798,3,129801,0,0,-6735,6735,0,0,0,294631090,13605,294644695,0,0,294637825,6870,294644695
2019-06-21,516,516,511,514,215168,0.0,-500,0,500,0,0,0,0,48779,3,48782,500,0,48279,3,48782,-1140000,0,1140030,-30,0,0,0,110510440,6810,110517250,1140000,0,109370410,6840,110517250
2019-06-24,514,515,510,514,175100,0.0,0,0,0,0,0,0,0,39698,0,39698,0,0,39698,0,39698,0,0,0,0,0,0,0,89659425,0,89659425,0,0,89659425,0,89659425
2019-06-25,514,518,512,514,46997,0.0,0,0,0,0,0,0,0,10655,0,10655,0,0,10655,0,10655,0,0,0,0,0,0,0,24173605,0,24173605,0,0,24173605,0,24173605
2019-06-26,514,514,512,514,36014,0.0,0,1,-1,0,0,0,1,8164,0,8165,0,0,8165,0,8165,0,2270,-2270,0,0,0,2270,18524455,0,18526725,0,0,18526725,0,18526725
2019-06-27,509,512,508,508,302493,-1.1673151750972763,0,3633,-3633,0,0,0,3633,64947,0,68580,0,0,68580,0,68580,0,8156085,-8156085,0,0,0,8156085,146572355,0,154728440,0,0,154728440,0,154728440
2019-06-28,510,513,508,508,24277,0.0,0,0,3,-3,0,0,0,5504,0,5504,0,0,5501,3,5504,0,0,6765,-6765,0,0,0,12356795,0,12356795,0,0,12350030,6765,12356795
2019-07-01,514,514,508,510,476,0.39370078740157477,0,0,3,-3,0,0,0,108,0,108,0,0,105,3,108,0,0,6810,-6810,0,0,0,242580,0,242580,0,0,235770,6810,242580
2019-07-02,515,515,504,510,70864,0.0,0,3,-3,0,0,0,3,16063,0,16066,0,0,16066,0,16066,0,6695,-6695,0,0,0,6695,35844555,0,35851250,0,0,35851250,0,35851250
2019-07-03,509,509,505,505,124481,-0.9803921568627451,0,4503,-4503,0,0,0,4503,23719,0,28222,0,0,28222,0,28222,0,10045035,-10045035,0,0,0,10045035,52947385,0,62992420,0,0,62992420,0,62992420
2019-07-04,509,509,505,505,83412,0.0,0,0,0,0,0,0,0,18911,0,18911,0,0,18911,0,18911,0,0,0,0,0,0,0,42186550,0,42186550,0,0,42186550,0,42186550
2019-07-05,509,509,503,505,61526,0.0,0,1811,-1811,0,0,0,1811,12138,0,13949,0,0,13949,0,13949,0,4029480,-4029480,0,0,0,4029480,27067530,0,31097010,0,0,31097010,0,31097010
2019-07-08,508,508,502,504,136532,-0.19801980198019803,0,4503,-4503,0,0,0,4503,26451,0,30954,0,0,30954,0,30954,0,10019175,-10019175,0,0,0,10019175,58942130,0,68961305,0,0,68961305,0,68961305
2019-07-09,505,505,502,505,28498,0.1984126984126984,0,912,-912,0,0,0,912,5549,0,6461,0,0,6461,0,6461,0,2026985,-2026985,0,0,0,2026985,12320380,0,14347365,0,0,14347365,0,14347365
2019-07-10,504,505,502,504,118496,-0.19801980198019803,0,9005,-9005,0,0,0,9005,17860,0,26865,0,0,26865,0,26865,0,19991125,-19991125,0,0,0,19991125,39716920,0,59708045,0,0,59708045,0,59708045
2019-07-11,502,505,501,505,254062,0.1984126984126984,0,6502,-6502,0,0,0,6502,51098,0,57600,0,0,57600,0,57600,0,14401945,-14401945,0,0,0,14401945,113459800,0,127861745,0,0,127861745,0,127861745
2019-07-12,504,505,502,504,106997,-0.19801980198019803,-7,2,5,0,0,0,2,24256,0,24258,7,0,24251,0,24258,-15575,4455,11120,0,0,0,4455,53914215,0,53918670,15575,0,53903095,0,53918670
2019-07-15,510,510,502,505,41099,0.1984126984126984,0,0,-897,897,0,0,0,8418,900,9318,0,0,9315,3,9318,0,0,-1995735,1995735,0,0,0,18717715,2002500,20720215,0,0,20713450,6765,20720215
2019-07-16,509,509,502,505,48333,0.0,0,0,-2,2,0,0,0,10955,3,10958,0,0,10957,1,10958,0,0,-4425,4425,0,0,0,24381900,6675,24388575,0,0,24386325,2250,24388575
2019-07-17,509,509,501,504,73267,-0.19801980198019803,-2402,1,2400,1,0,0,1,16609,1,16611,2402,0,14209,0,16611,-5332440,2225,5327995,2220,0,0,2225,36828525,2220,36832970,5332440,0,31500530,0,36832970
2019-07-18,505,505,501,504,103892,0.0,0,1,-501,500,0,0,1,23053,500,23554,0,0,23554,0,23554,0,2215,-1109715,1107500,0,0,2215,51158245,1107500,52267960,0,0,52267960,0,52267960
2019-07-19,505,505,503,503,41810,-0.1984126984126984,0,2000,-2000,0,0,0,2000,7479,0,9479,0,0,9479,0,9479,0,4440000,-4440000,0,0,0,4440000,16619420,0,21059420,0,0,21059420,0,21059420
2019-07-22,510,510,502,504,88560,0.19880715705765406,0,0,-4,4,0,0,0,20074,4,20078,0,0,20078,0,20078,0,0,-8880,8880,0,0,0,44588730,8880,44597610,0,0,44597610,0,44597610
2019-07-23,509,509,503,503,124724,-0.1984126984126984,0,1,-1,0,0,0,1,28276,0,28277,0,0,28277,0,28277,0,2225,-2225,0,0,0,2225,62901080,0,62903305,0,0,62903305,0,62903305
2019-07-24,505,505,502,504,33707,0.19880715705765406,0,1,-1,0,0,0,1,7641,0,7642,0,0,7642,0,7642,0,2225,-2225,0,0,0,2225,16974985,0,16977210,0,0,16977210,0,16977210
2019-07-25,504,504,501,504,34082,0.0,0,0,0,0,0,0,0,7727,0,7727,0,0,7727,0,7727,0,0,0,0,0,0,0,17144235,0,17144235,0,0,17144235,0,17144235
2019-07-26,504,504,501,503,53256,-0.1984126984126984,0,1,-1,0,0,0,1,12073,0,12074,0,0,12074,0,12074,0,2225,-2225,0,0,0,2225,26758325,0,26760550,0,0,26760550,0,26760550
2019-07-29,507,507,501,503,133519,0.0,-2500,2,2498,0,0,0,2,30269,0,30271,2500,0,27771,0,30271,-5537500,4430,5533070,0,0,0,4430,67087750,0,67092180,5537500,0,61554680,0,67092180
2019-07-30,503,503,502,502,41020,-0.19880715705765406,0,1,1,-2,0,0,1,9299,0,9300,0,0,9298,2,9300,0,2220,2220,-4440,0,0,2220,20642880,0,20645100,0,0,20640660,4440,20645100
2019-07-31,505,505,501,503,62933,0.199203187250996,1,1,-2,0,0,1,1,14266,0,14268,0,0,14268,0,14268,2220,2215,-4435,0,0,2220,2215,31599290,0,31603725,0,0,31603725,0,31603725
2019-08-01,502,506,502,505,22327,0.3976143141153081,0,1001,-1001,0,0,0,1001,4061,0,5062,0,0,5062,0,5062,0,2222220,-2222220,0,0,0,2222220,9015585,0,11237805,0,0,11237805,0,11237805
2019-08-02,503,503,501,503,51077,-0.39603960396039606,0,2001,-1997,-4,0,0,2001,9579,0,11580,0,0,11576,4,11580,0,4442220,-4433340,-8880,0,0,4442220,21260380,0,25702600,0,0,25693720,8880,25702600
2019-08-05,505,505,495,498,524793,-0.9940357852882704,0,10003,-10003,0,0,0,10003,108976,0,118979,0,0,118979,0,118979,0,22046610,-22046610,0,0,0,22046610,240128715,0,262175325,0,0,262175325,0,262175325
2019-08-06,498,500,496,498,141895,0.0,0,0,0,0,0,0,0,32170,0,32170,0,0,32170,0,32170,0,0,0,0,0,0,0,70721310,0,70721310,0,0,70721310,0,70721310
2019-08-07,498,498,495,497,175806,-0.2008032128514056,0,0,0,0,0,0,0,39858,0,39858,0,0,39858,0,39858,0,0,0,0,0,0,0,87475350,0,87475350,0,0,87475350,0,87475350
2019-08-08,496,498,494,498,80391,0.2012072434607646,0,1001,-1001,0,0,0,1001,17225,0,18226,0,0,18226,0,18226,0,2196470,-2196470,0,0,0,2196470,37701600,0,39898070,0,0,39898070,0,39898070
2019-08-09,504,504,494,494,451371,-0.8032128514056224,0,-55107,54038,1069,0,0,7002,94260,1071,102333,0,62109,40222,2,102333,0,-120058250,117711855,2346395,0,0,15339370,205783500,2350845,223473715,0,135397620,88071645,4450,223473715
2019-08-12,496,496,492,496,104223,0.4048582995951417,0,6400,-6400,0,0,0,6400,17229,0,23629,0,0,23629,0,23629,0,13961130,-13961130,0,0,0,13961130,37596715,0,51557845,0,0,51557845,0,51557845
2019-08-13,501,501,491,495,63740,-0.20161290322580644,0,4586,-4576,-10,0,0,4586,9865,0,14451,0,0,14441,10,14451,0,9979535,-9957385,-22150,0,0,9979535,21471545,0,31451080,0,0,31428930,22150,31451080
2019-08-14,493,498,491,493,664603,-0.40404040404040403,0,6000,-6000,0,0,0,6000,144676,0,150676,0,0,150676,0,150676,0,13028055,-13028055,0,0,0,13028055,313957575,0,326985630,0,0,326985630,0,326985630
2019-08-16,497,497,491,497,16108,0.8113590263691683,0,1723,-1723,0,0,0,1723,1929,0,3652,0,0,3652,0,3652,0,3738910,-3738910,0,0,0,3738910,4186310,0,7925220,0,0,7925220,0,7925220
2019-08-19,498,498,496,496,18154,-0.2012072434607646,0,0,0,0,0,0,0,4116,0,4116,0,0,4116,0,4116,0,0,0,0,0,0,0,9015075,0,9015075,0,0,9015075,0,9015075
2019-08-20,498,498,495,497,39838,0.20161290322580644,0,0,0,0,0,0,0,9032,0,9032,0,0,9032,0,9032,0,0,0,0,0,0,0,19837600,0,19837600,0,0,19837600,0,19837600
2019-08-21,501,501,494,498,35604,0.2012072434607646,0,101,-101,0,0,0,101,7971,0,8072,0,0,8072,0,8072,0,221190,-221190,0,0,0,221190,17432910,0,17654100,0,0,17654100,0,17654100
2019-08-22,498,498,495,497,64944,-0.2008032128514056,0,0,0,0,0,0,0,14724,0,14724,0,0,14724,0,14724,0,0,0,0,0,0,0,32318730,0,32318730,0,0,32318730,0,32318730
2019-08-23,500,500,493,496,40592,-0.2012072434607646,0,3,-3,0,0,0,3,9200,0,9203,0,0,9203,0,9203,0,6560,-6560,0,0,0,6560,20105580,0,20112140,0,0,20112140,0,20112140
2019-08-26,501,501,495,495,29746,-0.20161290322580644,0,0,0,0,0,0,0,6744,0,6744,0,0,6744,0,6744,0,0,0,0,0,0,0,14761535,0,14761535,0,0,14761535,0,14761535
2019-08-27,496,496,493,496,97086,0.20202020202020202,0,1,-829,828,0,0,1,21182,828,22011,0,0,22011,0,22011,0,2180,-1807220,1805040,0,0,2180,46203690,1805040,48010910,0,0,48010910,0,48010910
2019-08-28,496,496,494,496,26782,0.0,0,1,-1,0,0,0,1,6071,0,6072,0,0,6072,0,6072,0,2190,-2190,0,0,0,2190,13295090,0,13297280,0,0,13297280,0,13297280
2019-08-29,497,497,495,497,216,0.20161290322580644,0,0,0,0,0,0,0,49,0,49,0,0,49,0,49,0,0,0,0,0,0,0,107370,0,107370,0,0,107370,0,107370
2019-08-30,498,498,495,498,57014,0.2012072434607646,0,0,0,0,0,0,0,12926,0,12926,0,0,12926,0,12926,0,0,0,0,0,0,0,28346070,0,28346070,0,0,28346070,0,28346070
2019-09-02,498,498,494,498,168025,0.0,0,2,477,-479,0,0,2,38092,0,38094,0,0,37615,479,38094,0,4380,1049420,-1053800,0,0,4380,83355175,0,83359555,0,0,82305755,1053800,83359555
2019-09-03,496,499,496,498,30231,0.0,0,0,0,0,0,0,0,6854,0,6854,0,0,6854,0,6854,0,0,0,0,0,0,0,15060155,0,15060155,0,0,15060155,0,15060155
2019-09-04,499,499,496,498,200665,0.0,0,-4300,4300,0,0,0,0,45494,0,45494,0,4300,41194,0,45494,0,-9438500,9438500,0,0,0,0,99875360,0,99875360,0,9438500,90436860,0,99875360
2019-09-05,499,499,496,498,63370,0.0,0,0,0,0,0,0,0,14367,0,14367,0,0,14367,0,14367,0,0,0,0,0,0,0,31555180,0,31555180,0,0,31555180,0,31555180
2019-09-06,499,501,498,501,55192,0.6024096385542169,0,0,0,0,0,0,0,12513,0,12513,0,0,12513,0,12513,0,0,0,0,0,0,0,27561005,0,27561005,0,0,27561005,0,27561005
2019-09-09,502,502,498,502,47103,0.19960079840319359,0,1,-1,0,0,0,1,10678,0,10679,0,0,10679,0,10679,0,2200,-2200,0,0,0,2200,23493140,0,23495340,0,0,23495340,0,23495340
2019-09-10,502,503,499,502,50772,0.0,0,0,648,-648,0,0,0,11511,0,11511,0,0,10863,648,11511,0,0,1438560,-1438560,0,0,0,25537390,0,25537390,0,0,24098830,1438560,25537390
2019-09-11,502,505,502,505,40786,0.5976095617529881,0,0,0,0,0,0,0,9247,0,9247,0,0,9247,0,9247,0,0,0,0,0,0,0,20564300,0,20564300,0,0,20564300,0,20564300
2019-09-16,512,513,503,510,105541,0.9900990099009901,0,0,0,0,0,0,0,23928,0,23928,0,0,23928,0,23928,0,0,0,0,0,0,0,53649535,0,53649535,0,0,53649535,0,53649535
2019-09-17,513,513,506,508,40354,-0.39215686274509803,0,0,0,0,0,0,0,9149,0,9149,0,0,9149,0,9149,0,0,0,0,0,0,0,20496330,0,20496330,0,0,20496330,0,20496330
2019-09-18,508,509,505,507,31325,-0.19685039370078738,0,1,-1,0,0,0,1,7101,0,7102,0,0,7102,0,7102,0,2240,-2240,0,0,0,2240,15875450,0,15877690,0,0,15877690,0,15877690
2019-09-19,508,508,505,508,62399,0.19723865877712032,0,0,0,0,0,0,0,14147,0,14147,0,0,14147,0,14147,0,0,0,0,0,0,0,31682620,0,31682620,0,0,31682620,0,31682620
2019-09-20,508,513,508,513,262310,0.984251968503937,0,0,0,0,0,0,0,59470,0,59470,0,0,59470,0,59470,0,0,0,0,0,0,0,134361835,0,134361835,0,0,134361835,0,134361835
2019-09-23,514,514,511,514,95295,0.1949317738791423,0,0,0,0,0,0,0,21605,0,21605,0,0,21605,0,21605,0,0,0,0,0,0,0,48884260,0,48884260,0,0,48884260,0,48884260
2019-09-24,514,514,512,514,25759,0.0,0,1,-1,0,0,0,1,5839,0,5840,0,0,5840,0,5840,0,2265,-2265,0,0,0,2265,13225360,0,13227625,0,0,13227625,0,13227625
2019-09-25,515,515,512,515,29437,0.19455252918287938,0,0,0,0,0,0,0,6674,0,6674,0,0,6674,0,6674,0,0,0,0,0,0,0,15154200,0,15154200,0,0,15154200,0,15154200
2019-09-26,514,516,513,516,16037,0.1941747572815534,0,1,-1,0,0,0,1,3635,0,3636,0,0,3636,0,3636,0,2275,-2275,0,0,0,2275,8268705,0,8270980,0,0,8270980,0,8270980
2019-09-27,506,507,502,506,42449,-1.937984496124031,0,0,0,0,0,0,0,9624,0,9624,0,0,9624,0,9624,0,0,0,0,0,0,0,21466560,0,21466560,0,0,21466560,0,21466560
2019-09-30,506,507,504,506,31599,0.0,0,0,0,0,0,0,0,7164,0,7164,0,0,7164,0,7164,0,0,0,0,0,0,0,16001545,0,16001545,0,0,16001545,0,16001545
2019-10-01,506,506,503,506,110248,0.0,0,0,-90,90,0,0,0,24905,90,24995,0,0,24995,0,24995,0,0,-200250,200250,0,0,0,55473585,200250,55673835,0,0,55673835,0,55673835
2019-10-02,506,506,503,506,24290,0.0,0,1,-1,0,0,0,1,5506,0,5507,0,0,5507,0,5507,0,2235,-2235,0,0,0,2235,12282890,0,12285125,0,0,12285125,0,12285125
2019-10-04,506,507,506,506,38030,0.0,0,0,0,0,0,0,0,8622,0,8622,0,0,8622,0,8622,0,0,0,0,0,0,0,19270175,0,19270175,0,0,19270175,0,19270175
2019-10-07,506,507,504,506,37121,0.0,0,0,0,0,0,0,0,8416,0,8416,0,0,8416,0,8416,0,0,0,0,0,0,0,18777945,0,18777945,0,0,18777945,0,18777945
2019-10-08,505,507,505,505,8402,-0.1976284584980237,0,0,0,0,0,0,0,1905,0,1905,0,0,1905,0,1905,0,0,0,0,0,0,0,4253440,0,4253440,0,0,4253440,0,4253440
2019-10-10,507,507,502,506,84281,0.19801980198019803,0,0,0,0,0,0,0,19108,0,19108,0,0,19108,0,19108,0,0,0,0,0,0,0,42522260,0,42522260,0,0,42522260,0,42522260
2019-10-11,505,505,503,505,7591,-0.1976284584980237,0,1,-1,0,0,0,1,1720,0,1721,0,0,1721,0,1721,0,2230,-2230,0,0,0,2230,3835485,0,3837715,0,0,3837715,0,3837715
2019-10-14,506,506,505,505,14661,0.0,0,0,0,0,0,0,0,3324,0,3324,0,0,3324,0,3324,0,0,0,0,0,0,0,7412535,0,7412535,0,0,7412535,0,7412535
2019-10-15,506,506,503,505,13320,0.0,0,0,0,0,0,0,0,3020,0,3020,0,0,3020,0,3020,0,0,0,0,0,0,0,6725610,0,6725610,0,0,6725610,0,6725610
2019-10-16,506,506,502,505,12826,0.0,0,0,0,0,0,0,0,2908,0,2908,0,0,2908,0,2908,0,0,0,0,0,0,0,6475385,0,6475385,0,0,6475385,0,6475385
2019-10-17,505,505,503,505,50009,0.0,0,0,0,0,0,0,0,11338,0,11338,0,0,11338,0,11338,0,0,0,0,0,0,0,25252165,0,25252165,0,0,25252165,0,25252165
2019-10-18,506,506,502,505,126105,0.0,0,0,0,0,0,0,0,28590,0,28590,0,0,28590,0,28590,0,0,0,0,0,0,0,63597155,0,63597155,0,0,63597155,0,63597155
2019-10-21,505,505,503,505,83800,0.0,0,1,-1,0,0,0,1,18998,0,18999,0,0,18999,0,18999,0,2225,-2225,0,0,0,2225,42313605,0,42315830,0,0,42315830,0,42315830
2019-10-22,507,507,502,506,39913,0.19801980198019803,0,0,1,-1,0,0,0,9049,0,9049,0,0,9048,1,9049,0,0,2240,-2240,0,0,0,20120780,0,20120780,0,0,20118540,2240,20120780
2019-10-23,506,506,501,505,55589,-0.1976284584980237,0,0,0,0,0,0,0,12603,0,12603,0,0,12603,0,12603,0,0,0,0,0,0,0,28026000,0,28026000,0,0,28026000,0,28026000
2019-10-24,505,505,501,505,83271,0.0,0,0,0,0,0,0,0,18879,0,18879,0,0,18879,0,18879,0,0,0,0,0,0,0,41883235,0,41883235,0,0,41883235,0,41883235
2019-10-25,505,505,498,503,241311,-0.39603960396039606,0,0,0,0,0,0,0,54709,0,54709,0,0,54709,0,54709,0,0,0,0,0,0,0,120580820,0,120580820,0,0,120580820,0,120580820
2019-10-28,505,505,501,501,122117,-0.3976143141153081,0,0,0,0,0,0,0,27686,0,27686,0,0,27686,0,27686,0,0,0,0,0,0,0,61265470,0,61265470,0,0,61265470,0,61265470
2019-10-29,505,505,502,502,30985,0.19960079840319359,0,0,0,0,0,0,0,7025,0,7025,0,0,7025,0,7025,0,0,0,0,0,0,0,15560400,0,15560400,0,0,15560400,0,15560400
2019-10-30,505,505,501,505,61305,0.5976095617529881,0,0,0,0,0,0,0,13899,0,13899,0,0,13899,0,13899,0,0,0,0,0,0,0,30786315,0,30786315,0,0,30786315,0,30786315
2019-10-31,501,505,500,504,146937,-0.19801980198019803,0,0,0,0,0,0,0,33313,0,33313,0,0,33313,0,33313,0,0,0,0,0,0,0,73874380,0,73874380,0,0,73874380,0,73874380
2019-11-01,504,504,499,501,167941,-0.5952380952380952,-1,0,1,0,0,0,0,38075,0,38075,1,0,38074,0,38075,-2225,0,2225,0,0,0,0,84231585,0,84231585,2225,0,84229360,0,84231585
2019-11-04,504,504,503,503,37513,0.39920159680638717,0,0,0,0,0,0,0,8505,0,8505,0,0,8505,0,8505,0,0,0,0,0,0,0,18883610,0,18883610,0,0,18883610,0,18883610
2019-11-05,504,504,500,503,105797,0.0,0,-13202,13202,0,0,0,52,23934,0,23986,0,13254,10732,0,23986,0,-29201160,29201160,0,0,0,115180,52979930,0,53095110,0,29316340,23778770,0,53095110
2019-11-06,504,504,500,503,157743,0.0,0,2,-2,0,0,0,2,35761,0,35763,0,0,35763,0,35763,0,4435,-4435,0,0,0,4435,79150695,0,79155130,0,0,79155130,0,79155130
2019-11-07,503,503,501,503,83284,0.0,0,1,-1,0,0,0,1,18881,0,18882,0,0,18882,0,18882,0,2220,-2220,0,0,0,2220,41904220,0,41906440,0,0,41906440,0,41906440
2019-11-08,502,504,502,504,89715,0.19880715705765406,0,2,-2,0,0,0,2,20338,0,20340,0,0,20340,0,20340,0,4440,-4440,0,0,0,4440,45150880,0,45155320,0,0,45155320,0,45155320
2019-11-11,504,504,502,504,61610,0.0,0,2,-2,0,0,0,2,13966,0,13968,0,0,13968,0,13968,0,4445,-4445,0,0,0,4445,31006300,0,31010745,0,0,31010745,0,31010745
2019-11-12,503,505,502,505,80056,0.1984126984126984,0,1,298,-299,0,0,1,18149,0,18150,0,0,17851,299,18150,0,2225,663050,-665275,0,0,2225,40327170,0,40329395,0,0,39664120,665275,40329395
2019-11-13,505,505,501,505,130564,0.0,0,2,-2,0,0,0,2,29599,0,29601,0,0,29601,0,29601,0,4455,-4455,0,0,0,4455,65657250,0,65661705,0,0,65661705,0,65661705
2019-11-14,505,505,501,504,104470,-0.19801980198019803,0,2,-2,0,0,0,2,23683,0,23685,0,0,23685,0,23685,0,4455,-4455,0,0,0,4455,52578470,0,52582925,0,0,52582925,0,52582925
2019-11-15,504,504,502,504,69254,0.0,0,0,0,0,0,0,0,15701,0,15701,0,0,15701,0,15701,0,0,0,0,0,0,0,34866290,0,34866290,0,0,34866290,0,34866290
2019-11-18,503,506,502,506,254711,0.3968253968253968,0,0,2489,-2489,0,0,0,57747,0,57747,0,0,55258,2489,57747,0,0,5550470,-5550470,0,0,0,128616250,0,128616250,0,0,123065780,5550470,128616250
2019-11-19,505,507,504,507,138556,0.1976284584980237,0,0,0,0,0,0,0,31413,0,31413,0,0,31413,0,31413,0,0,0,0,0,0,0,70134920,0,70134920,0,0,70134920,0,70134920
2019-11-20,507,507,505,507,9024,0.0,0,1,-1,0,0,0,1,2045,0,2046,0,0,2046,0,2046,0,2240,-2240,0,0,0,2240,4570750,0,4572990,0,0,4572990,0,4572990
2019-11-21,507,507,505,505,64177,-0.39447731755424065,0,2,-2,0,0,0,2,14548,0,14550,0,0,14550,0,14550,0,4475,-4475,0,0,0,4475,32486910,0,32491385,0,0,32491385,0,32491385
2019-11-22,504,506,503,506,54358,0.19801980198019803,0,1,99,-100,0,0,1,12323,0,12324,0,0,12224,100,12324,0,2230,221270,-223500,0,0,2230,27481915,0,27484145,0,0,27260645,223500,27484145
2019-11-25,505,508,505,508,37650,0.3952569169960474,378,1,321,-700,0,378,1,8157,0,8536,0,0,7836,700,8536,844830,2240,720930,-1568000,0,844830,2240,18278940,0,19126010,0,0,17558010,1568000,19126010
2019-11-26,508,509,506,508,189991,0.0,1335,2,-1337,0,0,1335,2,41737,0,43074,0,0,43074,0,43074,2997075,4485,-3001560,0,0,2997075,4485,93651860,0,96653420,0,0,96653420,0,96653420
2019-11-27,508,509,505,508,110239,0.0,1335,1,-1336,0,0,1335,1,23657,0,24993,0,0,24993,0,24993,2997075,2235,-2999310,0,0,2997075,2235,53038405,0,56037715,0,0,56037715,0,56037715
2019-11-28,508,509,505,508,47575,0.0,1385,2,-1387,0,0,1385,2,9399,0,10786,0,0,10786,0,10786,3109325,4490,-3113815,0,0,3109325,4490,21060825,0,24174640,0,0,24174640,0,24174640
2019-11-29,508,508,505,507,116899,-0.19685039370078738,1335,2,-1337,0,0,1335,2,25166,0,26503,0,0,26503,0,26503,2997075,4485,-3001560,0,0,2997075,4485,56305630,0,59307190,0,0,59307190,0,59307190
2019-12-02,506,508,505,508,41713,0.19723865877712032,1338,0,-1338,0,0,1338,0,8119,0,9457,0,0,9457,0,9457,2997120,0,-2997120,0,0,2997120,0,18182040,0,21179160,0,0,21179160,0,21179160
2019-12-03,508,509,508,508,21458,0.0,1335,2,-537,-800,0,1335,2,3528,0,4865,0,0,4065,800,4865,2997075,4490,-1205565,-1796000,0,2997075,4490,7920365,0,10921930,0,0,9125930,1796000,10921930
2019-12-04,508,508,507,507,30906,-0.19685039370078738,0,1,-1,0,0,0,1,7006,0,7007,0,0,7007,0,7007,0,2245,-2245,0,0,0,2245,15698465,0,15700710,0,0,15700710,0,15700710
2019-12-05,506,508,506,508,204577,0.19723865877712032,0,1,45,-46,0,0,1,46380,0,46381,0,0,46335,46,46381,0,2240,101030,-103270,0,0,2240,103891430,0,103893670,0,0,103790400,103270,103893670
2019-12-06,510,510,507,510,60309,0.39370078740157477,-8391,0,9261,-870,0,0,0,13673,0,13673,8391,0,4412,870,13673,-18815860,0,20773360,-1957500,0,0,0,30698960,0,30698960,18815860,0,9925600,1957500,30698960
2019-12-09,510,510,508,510,35423,0.0,0,0,0,0,0,0,0,8031,0,8031,0,0,8031,0,8031,0,0,0,0,0,0,0,18029615,0,18029615,0,0,18029615,0,18029615
2019-12-10,514,514,507,511,170252,0.19607843137254902,0,2,-1,-1,0,0,2,38597,0,38599,0,0,38598,1,38599,0,4505,-2245,-2260,0,0,4505,86530350,0,86534855,0,0,86532595,2260,86534855
2019-12-11,510,511,508,510,50437,-0.19569471624266144,0,2,-2,0,0,0,2,11433,0,11435,0,0,11435,0,11435,0,4500,-4500,0,0,0,4500,25683715,0,25688215,0,0,25688215,0,25688215
2019-12-12,510,511,508,510,44677,0.0,0,0,-23,23,0,0,0,10105,24,10129,0,0,10128,1,10129,0,0,-51625,51625,0,0,0,22691740,53880,22745620,0,0,22743365,2255,22745620
2019-12-13,511,511,509,511,22733,0.19607843137254902,0,0,0,0,0,0,0,5154,0,5154,0,0,5154,0,5154,0,0,0,0,0,0,0,11596530,0,11596530,0,0,11596530,0,11596530
2019-12-16,511,511,508,511,44328,0.0,0,2,-2,0,0,0,2,10048,0,10050,0,0,10050,0,10050,0,4500,-4500,0,0,0,4500,22579285,0,22583785,0,0,22583785,0,22583785
2019-12-17,510,512,505,512,297151,0.19569471624266144,0,1,2191,-2192,0,0,1,67368,0,67369,0,0,65177,2192,67369,0,2245,4951375,-4953620,0,0,2245,151853370,0,151855615,0,0,146901995,4953620,151855615
2019-12-18,512,512,508,512,179065,0.0,0,-27061,27061,0,0,0,2,40595,0,40597,0,27063,13534,0,40597,0,-60887240,60887240,0,0,0,4510,91280005,0,91284515,0,60891750,30392765,0,91284515
2019-12-19,512,512,510,510,60291,-0.390625,0,2,-2,0,0,0,2,13667,0,13669,0,0,13669,0,13669,0,4500,-4500,0,0,0,4500,30770770,0,30775270,0,0,30775270,0,30775270
2019-12-20,512,512,508,510,120472,0.0,0,1,-21,20,0,0,1,27292,20,27313,0,0,27313,0,27313,0,2245,-47145,44900,0,0,2245,61316665,44900,61363810,0,0,61363810,0,61363810
2019-12-23,513,513,510,510,39119,0.0,0,0,0,0,0,0,0,8869,0,8869,0,0,8869,0,8869,0,0,0,0,0,0,0,19957695,0,19957695,0,0,19957695,0,19957695
2019-12-24,510,513,509,513,20148,0.5882352941176471,0,0,545,-545,0,0,0,4568,0,4568,0,0,4023,545,4568,0,0,1231700,-1231700,0,0,0,10316675,0,10316675,0,0,9084975,1231700,10316675
2019-12-26,513,513,510,513,97324,0.0,0,-13254,13271,-17,0,0,0,22065,0,22065,0,13254,8794,17,22065,0,-29937770,29976275,-38505,0,0,0,49842120,0,49842120,0,29937770,19865845,38505,49842120
2019-12-27,504,506,500,506,178337,-1.364522417153996,0,886,-886,0,0,0,886,39546,0,40432,0,0,40432,0,40432,0,1966910,-1966910,0,0,0,1966910,87821930,0,89788840,0,0,89788840,0,89788840
2019-12-30,505,505,503,505,35665,-0.1976284584980237,0,1,-1,0,0,0,1,8085,0,8086,0,0,8086,0,8086,0,2230,-2230,0,0,0,2230,18029540,0,18031770,0,0,18031770,0,18031770
2020-01-02,504,506,503,506,48082,0.19801980198019803,0,0,490,-490,0,0,0,10901,0,10901,0,0,10411,490,10901,0,0,1095150,-1095150,0,0,0,24276775,0,24276775,0,0,23181625,1095150,24276775
2020-01-03,507,507,505,507,2739,0.1976284584980237,0,0,0,0,0,0,0,621,0,621,0,0,621,0,621,0,0,0,0,0,0,0,1391030,0,1391030,0,0,1391030,0,1391030
2020-01-06,507,507,504,506,132624,-0.19723865877712032,0,2,5,-7,0,0,2,30066,0,30068,0,0,30061,7,30068,0,4480,11200,-15680,0,0,4480,67082615,0,67087095,0,0,67071415,15680,67087095
2020-01-07,518,518,504,507,53097,0.1976284584980237,0,2,-2,0,0,0,2,12036,0,12038,0,0,12038,0,12038,0,4470,-4470,0,0,0,4470,26867105,0,26871575,0,0,26871575,0,26871575
2020-01-08,513,513,506,510,12998,0.591715976331361,0,1,-1,0,0,0,1,2946,0,2947,0,0,2947,0,2947,0,2240,-2240,0,0,0,2240,6611025,0,6613265,0,0,6613265,0,6613265
2020-01-09,509,509,503,507,133215,-0.5882352941176471,0,-3998,4003,-5,0,0,2,30200,0,30202,0,4000,26197,5,30202,0,-8935530,8946710,-11180,0,0,4470,67451600,0,67456070,0,8940000,58504890,11180,67456070
2020-01-10,506,507,504,506,54129,-0.19723865877712032,0,2,-2,0,0,0,2,12270,0,12272,0,0,12272,0,12272,0,4475,-4475,0,0,0,4475,27417405,0,27421880,0,0,27421880,0,27421880
2020-01-13,507,507,504,504,96698,-0.3952569169960474,0,2,-2,0,0,0,2,21921,0,21923,0,0,21923,0,21923,0,4460,-4460,0,0,0,4460,48845990,0,48850450,0,0,48850450,0,48850450
2020-01-14,510,510,503,505,97659,0.1984126984126984,0,0,-6,6,0,0,0,22135,6,22141,0,0,22141,0,22141,0,0,-13410,13410,0,0,0,49264695,13410,49278105,0,0,49278105,0,49278105
2020-01-15,510,510,503,505,23289,0.0,0,1,-1,0,0,0,1,5279,0,5280,0,0,5280,0,5280,0,2230,-2230,0,0,0,2230,11750160,0,11752390,0,0,11752390,0,11752390
2020-01-16,510,510,504,506,29076,0.19801980198019803,0,1,-1,0,0,0,1,6591,0,6592,0,0,6592,0,6592,0,2230,-2230,0,0,0,2230,14697960,0,14700190,0,0,14700190,0,14700190
2020-01-17,510,510,504,506,28092,0.0,0,1,-1,0,0,0,1,6368,0,6369,0,0,6369,0,6369,0,2235,-2235,0,0,0,2235,14224505,0,14226740,0,0,14226740,0,14226740
2020-01-20,507,507,504,507,60855,0.1976284584980237,0,0,0,0,0,0,0,13797,0,13797,0,0,13797,0,13797,0,0,0,0,0,0,0,30873675,0,30873675,0,0,30873675,0,30873675
2020-01-21,507,507,504,507,55276,0.0,0,0,0,0,0,0,0,12532,0,12532,0,0,12532,0,12532,0,0,0,0,0,0,0,27980100,0,27980100,0,0,27980100,0,27980100
2020-01-22,507,507,503,507,13280,0.0,0,1,11,-12,0,0,1,3010,0,3011,0,0,2999,12,3011,0,2225,24535,-26760,0,0,2225,6711885,0,6714110,0,0,6687350,26760,6714110
2020-01-23,507,507,504,507,107253,0.0,0,1,-1,0,0,0,1,24315,0,24316,0,0,24316,0,24316,0,2235,-2235,0,0,0,2235,54242840,0,54245075,0,0,54245075,0,54245075
2020-01-28,507,507,504,506,85428,-0.19723865877712032,0,1,-1,0,0,0,1,19367,0,19368,0,0,19368,0,19368,0,2235,-2235,0,0,0,2235,43255270,0,43257505,0,0,43257505,0,43257505
2020-01-29,507,507,504,506,83562,0.0,0,2,-3,1,0,0,2,18942,1,18945,0,0,18945,0,18945,0,4465,-6700,2235,0,0,4465,42286430,2235,42293130,0,0,42293130,0,42293130
2020-01-30,507,507,502,505,204838,-0.1976284584980237,0,2,-8,6,0,0,2,46432,6,46440,0,0,46440,0,46440,0,4460,-17840,13380,0,0,4460,103346580,13380,103364420,0,0,103364420,0,103364420
2020-01-31,506,506,504,506,94184,0.19801980198019803,0,0,4400,-4400,0,0,0,21345,8,21353,0,0,16945,4408,21353,0,0,9812000,-9812000,0,0,0,47629400,17840,47647240,0,0,37817400,9829840,47647240
2020-02-03,506,506,502,505,240252,-0.1976284584980237,0,0,0,0,0,0,0,54469,0,54469,0,0,54469,0,54469,0,0,0,0,0,0,0,121203205,0,121203205,0,0,121203205,0,121203205
2020-02-04,504,504,498,502,478511,-0.594059405940594,0,3,-3,0,0,0,3,108483,0,108486,0,0,108486,0,108486,0,6630,-6630,0,0,0,6630,239536655,0,239543285,0,0,239543285,0,239543285
2020-02-05,504,504,502,504,49118,0.398406374501992,0,0,0,0,0,0,0,11136,0,11136,0,0,11136,0,11136,0,0,0,0,0,0,0,24742270,0,24742270,0,0,24742270,0,24742270
2020-02-06,504,506,503,503,116057,-0.1984126984126984,0,2,-2,0,0,0,2,26310,0,26312,0,0,26312,0,26312,0,4455,-4455,0,0,0,4455,58586835,0,58591290,0,0,58591290,0,58591290
2020-02-07,505,505,503,503,23289,0.0,0,0,0,0,0,0,0,5280,0,5280,0,0,5280,0,5280,0,0,0,0,0,0,0,11721635,0,11721635,0,0,11721635,0,11721635
2020-02-10,504,504,501,503,93522,0.0,0,0,0,0,0,0,0,21203,0,21203,0,0,21203,0,21203,0,0,0,0,0,0,0,47057445,0,47057445,0,0,47057445,0,47057445
2020-02-11,506,506,500,503,131737,0.0,0,0,0,0,0,0,0,29867,0,29867,0,0,29867,0,29867,0,0,0,0,0,0,0,66057370,0,66057370,0,0,66057370,0,66057370
2020-02-12,506,506,501,503,38625,0.0,0,0,0,0,0,0,0,8757,0,8757,0,0,8757,0,8757,0,0,0,0,0,0,0,19415790,0,19415790,0,0,19415790,0,19415790
2020-02-13,503,504,499,503,227990,0.0,0,2,-2,0,0,0,2,51687,0,51689,0,0,51689,0,51689,0,4425,-4425,0,0,0,4425,114151535,0,114155960,0,0,114155960,0,114155960
2020-02-14,504,504,501,503,50759,0.0,0,0,0,0,0,0,0,11508,0,11508,0,0,11508,0,11508,0,0,0,0,0,0,0,25505630,0,25505630,0,0,25505630,0,25505630
2020-02-17,503,503,500,503,231280,0.0,0,15002,-15002,0,0,0,15002,37433,0,52435,0,0,52435,0,52435,0,33304420,-33304420,0,0,0,33304420,82730990,0,116035410,0,0,116035410,0,116035410
2020-02-18,506,506,506,506,8,0.5964214711729622,0,0,0,0,0,0,0,2,0,2,0,0,2,0,2,0,0,0,0,0,0,0,4470,0,4470,0,0,4470,0,4470
2020-02-19,503,504,502,502,39384,-0.7905138339920948,0,1,-1,0,0,0,1,8928,0,8929,0,0,8929,0,8929,0,2215,-2215,0,0,0,2215,19788630,0,19790845,0,0,19790845,0,19790845
2020-02-20,506,506,498,502,221091,0.0,0,3,-3,0,0,0,3,50122,0,50125,0,0,50125,0,50125,0,6610,-6610,0,0,0,6610,110437185,0,110443795,0,0,110443795,0,110443795
2020-02-21,506,506,498,501,69368,-0.199203187250996,0,1,-1,0,0,0,1,15726,0,15727,0,0,15727,0,15727,0,2205,-2205,0,0,0,2205,34654895,0,34657100,0,0,34657100,0,34657100
2020-02-24,504,504,499,501,359167,0.0,0,1,-1,0,0,0,1,81428,0,81429,0,0,81429,0,81429,0,2205,-2205,0,0,0,2205,179678695,0,179680900,0,0,179680900,0,179680900
2020-02-25,501,502,499,501,101651,0.0,0,1,-1,0,0,0,1,23045,0,23046,0,0,23046,0,23046,0,2210,-2210,0,0,0,2210,50909245,0,50911455,0,0,50911455,0,50911455
2020-02-26,500,503,498,502,90981,0.19960079840319359,0,0,0,0,0,0,0,20627,0,20627,0,0,20627,0,20627,0,0,0,0,0,0,0,45475525,0,45475525,0,0,45475525,0,45475525
2020-02-27,500,502,499,499,151828,-0.5976095617529881,0,0,0,0,0,0,0,34422,0,34422,0,0,34422,0,34422,0,0,0,0,0,0,0,75930635,0,75930635,0,0,75930635,0,75930635
2020-02-28,501,501,494,497,290376,-0.4008016032064128,0,6872,-6872,0,0,0,6872,58961,0,65833,0,0,65833,0,65833,0,15084030,-15084030,0,0,0,15084030,129322495,0,144406525,0,0,144406525,0,144406525
2020-03-02,501,501,494,499,348140,0.4024144869215292,0,36676,-36676,0,0,0,36676,42253,0,78929,0,0,78929,0,78929,0,80687200,-80687200,0,0,0,80687200,92465265,0,173152465,0,0,173152465,0,173152465
2020-03-03,500,500,497,497,219089,-0.4008016032064128,0,3398,-3398,0,0,0,3398,46273,0,49671,0,0,49671,0,49671,0,7458610,-7458610,0,0,0,7458610,101583785,0,109042395,0,0,109042395,0,109042395
2020-03-04,500,500,494,497,288308,0.0,0,0,0,0,0,0,0,65364,0,65364,0,0,65364,0,65364,0,0,0,0,0,0,0,142964975,0,142964975,0,0,142964975,0,142964975
2020-03-05,498,498,495,497,312607,0.0,0,29817,-29817,0,0,0,29817,41056,0,70873,0,0,70873,0,70873,0,65446880,-65446880,0,0,0,65446880,89998670,0,155445550,0,0,155445550,0,155445550
2020-03-06,498,498,495,498,200312,0.2012072434607646,0,20000,-20000,0,0,0,20000,25414,0,45414,0,0,45414,0,45414,0,43897095,-43897095,0,0,0,43897095,55756780,0,99653875,0,0,99653875,0,99653875
2020-03-09,496,503,493,493,946304,-1.0040160642570282,0,68944,-68944,0,0,0,68944,145598,0,214542,0,0,214542,0,214542,0,149953215,-149953215,0,0,0,149953215,317864920,0,467818135,0,0,467818135,0,467818135
2020-03-10,501,501,487,491,543698,-0.4056795131845842,0,15001,-15001,0,0,0,15001,108264,0,123265,0,0,123265,0,123265,0,32352160,-32352160,0,0,0,32352160,233853495,0,266205655,0,0,266205655,0,266205655
2020-03-11,493,493,488,491,77414,0.0,0,1,-1,0,0,0,1,17550,0,17551,0,0,17551,0,17551,0,2160,-2160,0,0,0,2160,37924840,0,37927000,0,0,37927000,0,37927000
2020-03-12,491,491,475,485,690640,-1.2219959266802443,0,1,-1,0,0,0,1,156578,0,156579,0,0,156579,0,156579,0,2165,-2165,0,0,0,2165,333773690,0,333775855,0,0,333775855,0,333775855
2020-03-13,478,478,464,476,987245,-1.8556701030927836,0,79986,-79986,0,0,0,79986,143838,0,223824,0,0,223824,0,223824,0,167620565,-167620565,0,0,0,167620565,298345920,0,465966485,0,0,465966485,0,465966485
2020-03-16,498,498,465,472,104783,-0.8403361344537815,0,2001,-2001,0,0,0,2001,21755,0,23756,0,0,23756,0,23756,0,4187090,-4187090,0,0,0,4187090,45443460,0,49630550,0,0,49630550,0,49630550
2020-03-17,469,469,463,467,364716,-1.059322033898305,180,41003,-41172,-11,0,180,41003,41504,0,82687,0,0,82676,11,82687,372600,84515620,-84865505,-22715,0,372600,84515620,85500540,0,170388760,0,0,170366045,22715,170388760
2020-03-18,466,466,463,463,230464,-0.8565310492505354,0,13984,-13984,0,0,0,13984,38266,0,52250,0,0,52250,0,52250,0,28629220,-28629220,0,0,0,28629220,78436700,0,107065920,0,0,107065920,0,107065920
2020-03-19,461,461,435,438,765831,-5.399568034557236,0,44502,-44502,0,0,0,44502,129124,0,173626,0,0,173626,0,173626,0,88637270,-88637270,0,0,0,88637270,253011655,0,341648925,0,0,341648925,0,341648925
2020-03-20,442,444,428,435,553084,-0.684931506849315,0,0,0,0,0,0,0,125393,0,125393,0,0,125393,0,125393,0,0,0,0,0,0,0,242588950,0,242588950,0,0,242588950,0,242588950
2020-03-23,439,461,438,438,700198,0.6896551724137931,-10996,0,10996,0,0,0,0,158746,0,158746,10996,0,147750,0,158746,-21601350,0,21601350,0,0,0,0,310244485,0,310244485,21601350,0,288643135,0,310244485
2020-03-24,438,457,438,457,500375,4.337899543378995,0,30000,-30000,0,0,0,30000,83443,0,113443,0,0,113443,0,113443,0,60000000,-60000000,0,0,0,60000000,166706710,0,226706710,0,0,226706710,0,226706710
2020-03-25,476,485,460,467,358409,2.1881838074398248,0,0,0,0,0,0,0,81257,0,81257,0,0,81257,0,81257,0,0,0,0,0,0,0,167872745,0,167872745,0,0,167872745,0,167872745
2020-03-26,466,471,466,469,454975,0.4282655246252677,0,0,0,0,0,0,0,103150,0,103150,0,0,103150,0,103150,0,0,0,0,0,0,0,213349425,0,213349425,0,0,213349425,0,213349425
2020-03-27,458,472,458,472,160412,0.6396588486140725,0,1,-1,0,0,0,1,36367,0,36368,0,0,36368,0,36368,0,2065,-2065,0,0,0,2065,75330110,0,75332175,0,0,75332175,0,75332175
2020-03-30,435,435,429,434,410425,-8.050847457627118,263,53901,-54164,0,0,263,53901,38886,0,93050,0,0,93050,0,93050,499700,102782400,-103282100,0,0,499700,102782400,74056600,0,177338700,0,0,177338700,0,177338700
2020-03-31,445,445,430,433,94550,-0.2304147465437788,0,502,-502,0,0,0,502,20934,0,21436,0,0,21436,0,21436,0,966315,-966315,0,0,0,966315,39973885,0,40940200,0,0,40940200,0,40940200
2020-04-01,429,435,429,431,83752,-0.4618937644341801,0,0,0,0,0,0,0,18988,0,18988,0,0,18988,0,18988,0,0,0,0,0,0,0,36212765,0,36212765,0,0,36212765,0,36212765
2020-04-02,433,433,419,433,32432,0.46403712296983757,0,2,-2,0,0,0,2,7351,0,7353,0,0,7353,0,7353,0,3810,-3810,0,0,0,3810,13995170,0,13998980,0,0,13998980,0,13998980
2020-04-03,437,438,432,436,148564,0.6928406466512702,0,1,-1,0,0,0,1,33681,0,33682,0,0,33682,0,33682,0,1915,-1915,0,0,0,1915,64491290,0,64493205,0,0,64493205,0,64493205
2020-04-06,437,437,433,437,197511,0.22935779816513763,-535,1,534,0,0,0,1,44778,0,44779,535,0,44244,0,44779,-1024525,1920,1022605,0,0,0,1920,86203030,0,86204950,1024525,0,85180425,0,86204950
2020-04-07,436,440,436,440,63828,0.6864988558352403,0,0,0,0,0,0,0,14471,0,14471,0,0,14471,0,14471,0,0,0,0,0,0,0,28080810,0,28080810,0,0,28080810,0,28080810
2020-04-08,441,441,437,440,66828,0.0,0,2,-2,0,0,0,2,15149,0,15151,0,0,15151,0,15151,0,3880,-3880,0,0,0,3880,29368565,0,29372445,0,0,29372445,0,29372445
2020-04-09,440,441,432,436,1919695,-0.9090909090909091,0,-433529,433529,0,0,0,1,435224,0,435225,0,433530,1695,0,435225,0,-832400245,832400245,0,0,0,1920,835687775,0,835689695,0,832402165,3287530,0,835689695
2020-04-10,437,437,434,436,55055,0.0,0,-10360,10360,0,0,0,0,12482,0,12482,0,10360,2122,0,12482,0,-19943000,19943000,0,0,0,0,24025390,0,24025390,0,19943000,4082390,0,24025390
2020-04-13,446,446,428,435,113190,-0.22935779816513763,-1,-1517,1518,0,0,0,2,25660,0,25662,1,1519,24142,0,25662,-1920,-2927880,2929800,0,0,0,3790,48841635,0,48845425,1920,2931670,45911835,0,48845425
2020-04-14,432,439,432,439,42105,0.9195402298850575,0,0,0,0,0,0,0,9546,0,9546,0,0,9546,0,9546,0,0,0,0,0,0,0,18293560,0,18293560,0,0,18293560,0,18293560
2020-04-16,431,438,431,438,3546,-0.22779043280182232,0,0,0,0,0,0,0,804,0,804,0,0,804,0,804,0,0,0,0,0,0,0,1549340,0,1549340,0,0,1549340,0,1549340
2020-04-17,439,442,436,442,258376,0.91324200913242,0,-26761,26761,0,0,0,1,58577,0,58578,0,26762,31816,0,58578,0,-51648730,51648730,0,0,0,1930,113270060,0,113271990,0,51650660,61621330,0,113271990
2020-04-20,442,443,439,442,193277,0.0,50,1,-51,0,0,50,1,43768,0,43819,0,0,43819,0,43819,97250,1940,-99190,0,0,97250,1940,85064540,0,85163730,0,0,85163730,0,85163730
2020-04-21,442,443,439,442,73704,0.0,0,0,0,0,0,0,0,16710,0,16710,0,0,16710,0,16710,0,0,0,0,0,0,0,32496075,0,32496075,0,0,32496075,0,32496075
2020-04-22,441,443,440,443,70030,0.22624434389140274,0,0,0,0,0,0,0,15877,0,15877,0,0,15877,0,15877,0,0,0,0,0,0,0,30990670,0,30990670,0,0,30990670,0,30990670
2020-04-23,442,444,441,444,135782,0.2257336343115124,0,1,-1,0,0,0,1,30783,0,30784,0,0,30784,0,30784,0,1955,-1955,0,0,0,1955,60180365,0,60182320,0,0,60182320,0,60182320
2020-04-24,442,445,442,445,163729,0.22522522522522523,0,0,18,-18,0,0,0,37120,0,37120,0,0,37102,18,37120,0,0,35280,-35280,0,0,0,72733000,0,72733000,0,0,72697720,35280,72733000
2020-04-27,445,447,441,444,169428,-0.22471910112359553,0,0,0,0,0,0,0,38412,0,38412,0,0,38412,0,38412,0,0,0,0,0,0,0,75335225,0,75335225,0,0,75335225,0,75335225
2020-04-28,446,446,443,445,60229,0.22522522522522523,1,0,-1,0,0,1,0,13654,0,13655,0,0,13655,0,13655,1965,0,-1965,0,0,1965,0,26766265,0,26768230,0,0,26768230,0,26768230
2020-04-29,445,445,443,445,7313,0.0,0,1,-1,0,0,0,1,1657,0,1658,0,0,1658,0,1658,0,1965,-1965,0,0,0,1965,3254405,0,3256370,0,0,3256370,0,3256370
2020-05-04,444,446,444,446,4975,0.22471910112359553,0,0,0,0,0,0,0,1128,0,1128,0,0,1128,0,1128,0,0,0,0,0,0,0,2217615,0,2217615,0,0,2217615,0,2217615
2020-05-06,446,447,445,445,101073,-0.2242152466367713,0,0,0,0,0,0,0,22915,0,22915,0,0,22915,0,22915,0,0,0,0,0,0,0,45062305,0,45062305,0,0,45062305,0,45062305
2020-05-07,444,446,444,446,49109,0.22471910112359553,0,0,0,0,0,0,0,11134,0,11134,0,0,11134,0,11134,0,0,0,0,0,0,0,21880840,0,21880840,0,0,21880840,0,21880840
2020-05-08,447,447,446,446,4172,0.0,0,1,-1,0,0,0,1,945,0,946,0,0,946,0,946,0,1975,-1975,0,0,0,1975,1865420,0,1867395,0,0,1867395,0,1867395
2020-05-11,445,447,445,447,8706,0.2242152466367713,0,0,0,0,0,0,0,1974,0,1974,0,0,1974,0,1974,0,0,0,0,0,0,0,3895025,0,3895025,0,0,3895025,0,3895025
2020-05-12,448,448,445,448,115858,0.22371364653243847,0,0,0,0,0,0,0,26267,0,26267,0,0,26267,0,26267,0,0,0,0,0,0,0,52002070,0,52002070,0,0,52002070,0,52002070
2020-05-13,449,452,449,452,98149,0.8928571428571428,0,0,0,0,0,0,0,22252,0,22252,0,0,22252,0,22252,0,0,0,0,0,0,0,44266840,0,44266840,0,0,44266840,0,44266840
2020-05-14,452,453,450,452,80360,0.0,0,0,0,0,0,0,0,18219,0,18219,0,0,18219,0,18219,0,0,0,0,0,0,0,36352105,0,36352105,0,0,36352105,0,36352105
2020-05-15,451,454,451,453,57221,0.22123893805309736,-493,0,493,0,0,0,0,12973,0,12973,493,0,12480,0,12973,-983535,0,983535,0,0,0,0,25967700,0,25967700,983535,0,24984165,0,25967700
2020-05-18,455,456,452,455,63259,0.44150110375275936,0,0,0,0,0,0,0,14342,0,14342,0,0,14342,0,14342,0,0,0,0,0,0,0,28823855,0,28823855,0,0,28823855,0,28823855
2020-05-19,456,456,455,455,17263,0.0,0,1,-1,0,0,0,1,3913,0,3914,0,0,3914,0,3914,0,2015,-2015,0,0,0,2015,7871940,0,7873955,0,0,7873955,0,7873955
2020-05-20,457,457,454,457,31987,0.43956043956043955,0,1,-1,0,0,0,1,7251,0,7252,0,0,7252,0,7252,0,2015,-2015,0,0,0,2015,14630020,0,14632035,0,0,14632035,0,14632035
2020-05-21,458,461,457,461,197586,0.87527352297593,0,0,0,0,0,0,0,44796,0,44796,0,0,44796,0,44796,0,0,0,0,0,0,0,91004315,0,91004315,0,0,91004315,0,91004315
2020-05-22,462,462,459,461,90492,0.0,0,2,-2,0,0,0,2,20514,0,20516,0,0,20516,0,20516,0,4060,-4060,0,0,0,4060,41679845,0,41683905,0,0,41683905,0,41683905
2020-05-25,461,463,459,463,124892,0.43383947939262474,0,0,0,0,0,0,0,28315,0,28315,0,0,28315,0,28315,0,0,0,0,0,0,0,57590590,0,57590590,0,0,57590590,0,57590590
2020-05-26,464,464,460,462,146796,-0.21598272138228944,0,0,0,0,0,0,0,33281,0,33281,0,0,33281,0,33281,0,0,0,0,0,0,0,67808385,0,67808385,0,0,67808385,0,67808385
2020-05-27,465,465,461,465,42454,0.6493506493506493,0,0,0,0,0,0,0,9625,0,9625,0,0,9625,0,9625,0,0,0,0,0,0,0,19775860,0,19775860,0,0,19775860,0,19775860
2020-05-28,466,468,465,468,28074,0.6451612903225806,0,0,0,0,0,0,0,6365,0,6365,0,0,6365,0,6365,0,0,0,0,0,0,0,13116955,0,13116955,0,0,13116955,0,13116955
2020-05-29,468,473,468,473,152697,1.0683760683760684,0,0,0,0,0,0,0,34619,0,34619,0,0,34619,0,34619,0,0,0,0,0,0,0,72161590,0,72161590,0,0,72161590,0,72161590
2020-06-01,474,474,472,472,134913,-0.21141649048625794,0,0,0,0,0,0,0,30587,0,30587,0,0,30587,0,30587,0,0,0,0,0,0,0,63932265,0,63932265,0,0,63932265,0,63932265
2020-06-02,472,473,467,470,125267,-0.423728813559322,0,3,-3,0,0,0,3,28397,0,28400,0,0,28400,0,28400,0,6250,-6250,0,0,0,6250,59095845,0,59102095,0,0,59102095,0,59102095
2020-06-03,462,471,462,469,32785,-0.2127659574468085,0,4,-4,0,0,0,4,7429,0,7433,0,0,7433,0,7433,0,8245,-8245,0,0,0,8245,15284650,0,15292895,0,0,15292895,0,15292895
2020-06-04,464,468,461,468,65266,-0.21321961620469082,0,1,-1,0,0,0,1,14796,0,14797,0,0,14797,0,14797,0,2050,-2050,0,0,0,2050,30284305,0,30286355,0,0,30286355,0,30286355
2020-06-05,468,470,467,467,3149,-0.2136752136752137,0,1,-1,0,0,0,1,713,0,714,0,0,714,0,714,0,2060,-2060,0,0,0,2060,1470915,0,1472975,0,0,1472975,0,1472975
2020-06-08,467,467,464,467,72857,0.0,0,0,0,0,0,0,0,16518,0,16518,0,0,16518,0,16518,0,0,0,0,0,0,0,33975525,0,33975525,0,0,33975525,0,33975525
2020-06-09,466,466,462,465,63797,-0.4282655246252677,0,1,-1,0,0,0,1,14463,0,14464,0,0,14464,0,14464,0,2050,-2050,0,0,0,2050,29626670,0,29628720,0,0,29628720,0,29628720
2020-06-10,465,465,461,463,29442,-0.43010752688172044,0,2,-2,0,0,0,2,6673,0,6675,0,0,6675,0,6675,0,4100,-4100,0,0,0,4100,13643705,0,13647805,0,0,13647805,0,13647805
2020-06-11,463,463,460,463,82896,0.0,0,0,0,0,0,0,0,18794,0,18794,0,0,18794,0,18794,0,0,0,0,0,0,0,38334620,0,38334620,0,0,38334620,0,38334620
2020-06-12,463,463,459,463,26976,0.0,0,1,-1,0,0,0,1,6115,0,6116,0,0,6116,0,6116,0,2040,-2040,0,0,0,2040,12424665,0,12426705,0,0,12426705,0,12426705
2020-06-15,463,463,459,463,87620,0.0,0,1,-1,0,0,0,1,19864,0,19865,0,0,19865,0,19865,0,2030,-2030,0,0,0,2030,40449335,0,40451365,0,0,40451365,0,40451365
2020-06-16,459,464,459,464,8032,0.21598272138228944,0,0,0,0,0,0,0,1821,0,1821,0,0,1821,0,1821,0,0,0,0,0,0,0,3720825,0,3720825,0,0,3720825,0,3720825
2020-06-17,462,464,460,462,34258,-0.43103448275862066,0,1,-1,0,0,0,1,7766,0,7767,0,0,7767,0,7767,0,2040,-2040,0,0,0,2040,15848280,0,15850320,0,0,15850320,0,15850320
2020-06-18,460,467,460,467,9964,1.0822510822510822,0,0,0,0,0,0,0,2259,0,2259,0,0,2259,0,2259,0,0,0,0,0,0,0,4606515,0,4606515,0,0,4606515,0,4606515
2020-06-19,461,463,457,457,38171,-2.141327623126338,0,5,-5,0,0,0,5,8649,0,8654,0,0,8654,0,8654,0,10200,-10200,0,0,0,10200,17613550,0,17623750,0,0,17623750,0,17623750
2020-06-22,466,466,457,457,347915,0.0,0,14814,-14814,0,0,0,14814,64064,0,78878,0,0,78878,0,78878,0,29948930,-29948930,0,0,0,29948930,129629145,0,159578075,0,0,159578075,0,159578075
2020-06-23,457,466,454,464,110204,1.5317286652078774,0,2,-2,0,0,0,2,24983,0,24985,0,0,24985,0,24985,0,4030,-4030,0,0,0,4030,50301280,0,50305310,0,0,50305310,0,50305310
2020-06-24,471,471,457,460,59488,-0.8620689655172413,0,3,-3,0,0,0,3,13484,0,13487,0,0,13487,0,13487,0,6080,-6080,0,0,0,6080,27297735,0,27303815,0,0,27303815,0,27303815
2020-06-25,466,466,459,462,80806,0.43478260869565216,0,0,0,0,0,0,0,18320,0,18320,0,0,18320,0,18320,0,0,0,0,0,0,0,37212770,0,37212770,0,0,37212770,0,37212770
2020-06-26,454,460,454,456,44910,-1.2987012987012987,0,1,-1,0,0,0,1,10181,0,10182,0,0,10182,0,10182,0,2015,-2015,0,0,0,2015,20514580,0,20516595,0,0,20516595,0,20516595
2020-06-29,455,457,454,457,39335,0.21929824561403508,0,0,0,0,0,0,0,8918,0,8918,0,0,8918,0,8918,0,0,0,0,0,0,0,17970360,0,17970360,0,0,17970360,0,17970360
2020-06-30,455,457,450,457,71622,0.0,-1,1,0,0,0,0,1,16237,0,16238,1,0,16237,0,16238,-2015,1990,25,0,0,0,1990,32622180,0,32624170,2015,0,32622155,0,32624170
2020-07-01,457,457,452,456,34254,-0.2188183807439825,0,3,-3,0,0,0,3,7763,0,7766,0,0,7766,0,7766,0,6015,-6015,0,0,0,6015,15551335,0,15557350,0,0,15557350,0,15557350
2020-07-02,450,465,450,456,10488,0.0,0,1,-1,0,0,0,1,2377,0,2378,0,0,2378,0,2378,0,2000,-2000,0,0,0,2000,4795715,0,4797715,0,0,4797715,0,4797715
2020-07-03,456,456,452,455,125474,-0.21929824561403508,900,1,-901,0,0,900,1,27546,0,28447,0,0,28447,0,28447,1800000,2005,-1802005,0,0,1800000,2005,55121885,0,56923890,0,0,56923890,0,56923890
2020-07-06,452,455,452,455,16664,0.0,0,0,0,0,0,0,0,3778,0,3778,0,0,3778,0,3778,0,0,0,0,0,0,0,7561375,0,7561375,0,0,7561375,0,7561375
2020-07-07,455,456,452,454,55514,-0.21978021978021978,0,0,0,0,0,270,0,12316,0,12586,270,0,12316,0,12586,0,0,0,0,0,544050,0,24662080,0,25206130,544050,0,24662080,0,25206130
2020-07-08,452,455,452,455,36283,0.22026431718061676,50,0,-50,0,0,50,0,8176,0,8226,0,0,8226,0,8226,100500,0,-100500,0,0,100500,0,16353720,0,16454220,0,0,16454220,0,16454220
2020-07-09,455,455,453,455,14304,0.0,0,1,-1,0,0,0,1,3242,0,3243,0,0,3243,0,3243,0,2005,-2005,0,0,0,2005,6500935,0,6502940,0,0,6502940,0,6502940
2020-07-10,453,455,450,453,90950,-0.43956043956043955,10,2,-12,0,0,10,2,20608,0,20620,0,0,20620,0,20620,20000,4000,-24000,0,0,20000,4000,41145390,0,41169390,0,0,41169390,0,41169390
2020-07-13,450,453,450,453,83196,0.0,0,0,0,0,0,0,0,18862,0,18862,0,0,18862,0,18862,0,0,0,0,0,0,0,37697315,0,37697315,0,0,37697315,0,37697315
2020-07-14,451,453,451,453,38109,0.0,0,0,0,0,0,0,0,8640,0,8640,0,0,8640,0,8640,0,0,0,0,0,0,0,17237230,0,17237230,0,0,17237230,0,17237230
2020-07-15,453,453,451,453,23046,0.0,0,2,-2,0,0,0,2,5223,0,5225,0,0,5225,0,5225,0,3995,-3995,0,0,0,3995,10445505,0,10449500,0,0,10449500,0,10449500
2020-07-16,451,453,450,453,11957,0.0,0,2,-2,0,0,0,2,2709,0,2711,0,0,2711,0,2711,0,3990,-3990,0,0,0,3990,5398700,0,5402690,0,0,5402690,0,5402690
2020-07-17,451,453,449,453,14343,0.0,0,2,-2,0,0,0,2,3250,0,3252,0,0,3252,0,3252,0,3970,-3970,0,0,0,3970,6463710,0,6467680,0,0,6467680,0,6467680
2020-07-20,453,453,449,452,104046,-0.22075055187637968,0,2,-2,0,0,0,2,23587,0,23589,0,0,23589,0,23589,0,3980,-3980,0,0,0,3980,46886835,0,46890815,0,0,46890815,0,46890815
2020-07-21,452,452,452,452,736,0.0,50,1,-51,0,0,50,1,116,0,167,0,0,167,0,167,99750,1995,-101745,0,0,99750,1995,231420,0,333165,0,0,333165,0,333165
2020-07-22,452,452,448,451,127198,-0.22123893805309736,0,2,-2,0,0,0,2,28836,0,28838,0,0,28838,0,28838,0,3960,-3960,0,0,0,3960,57118060,0,57122020,0,0,57122020,0,57122020
2020-07-23,450,450,446,448,239211,-0.6651884700665188,0,2,-2,0,0,0,2,54231,0,54233,0,0,54233,0,54233,0,3975,-3975,0,0,0,3975,107361800,0,107365775,0,0,107365775,0,107365775
2020-07-24,445,448,445,447,167826,-0.2232142857142857,0,3,-3,0,0,0,3,38046,0,38049,0,0,38049,0,38049,0,5915,-5915,0,0,0,5915,75117230,0,75123145,0,0,75123145,0,75123145
2020-07-27,447,447,446,446,80841,-0.22371364653243847,0,1,-1,0,0,0,1,18327,0,18328,0,0,18328,0,18328,0,1975,-1975,0,0,0,1975,36140145,0,36142120,0,0,36142120,0,36142120
2020-07-28,445,450,444,447,289375,0.2242152466367713,0,0,0,0,0,0,0,65606,0,65606,0,0,65606,0,65606,0,0,0,0,0,0,0,129228025,0,129228025,0,0,129228025,0,129228025
2020-07-29,445,449,444,447,130926,0.0,0,2,-2,0,0,0,2,29681,0,29683,0,0,29683,0,29683,0,3930,-3930,0,0,0,3930,58381180,0,58385110,0,0,58385110,0,58385110
2020-07-30,448,448,444,444,178867,-0.6711409395973155,0,10339,-10339,0,0,0,10339,30213,0,40552,0,0,40552,0,40552,0,20264440,-20264440,0,0,0,20264440,59224955,0,79489395,0,0,79489395,0,79489395
2020-07-31,443,448,443,445,59634,0.22522522522522523,0,0,0,0,0,0,0,13520,0,13520,0,0,13520,0,13520,0,0,0,0,0,0,0,26588205,0,26588205,0,0,26588205,0,26588205
2020-08-03,445,445,442,445,63511,0.0,0,2,-2,0,0,0,2,14397,0,14399,0,0,14399,0,14399,0,3920,-3920,0,0,0,3920,28177365,0,28181285,0,0,28181285,0,28181285
2020-08-04,445,445,443,445,211670,0.0,0,0,0,0,0,0,0,47989,0,47989,0,0,47989,0,47989,0,0,0,0,0,0,0,94079060,0,94079060,0,0,94079060,0,94079060
2020-08-05,444,444,440,443,235779,-0.44943820224719105,0,15401,-15401,0,0,0,15401,38054,0,53455,0,0,53455,0,53455,0,30108960,-30108960,0,0,0,30108960,74363750,0,104472710,0,0,104472710,0,104472710
2020-08-06,442,443,440,442,53370,-0.2257336343115124,0,1,-1,0,0,0,1,12099,0,12100,0,0,12100,0,12100,0,1950,-1950,0,0,0,1950,23582350,0,23584300,0,0,23584300,0,23584300
2020-08-07,442,442,439,442,136448,0.0,0,0,0,0,0,0,0,30935,0,30935,0,0,30935,0,30935,0,0,0,0,0,0,0,60065005,0,60065005,0,0,60065005,0,60065005
2020-08-10,442,442,439,442,66462,0.0,0,0,0,0,0,0,0,15068,0,15068,0,0,15068,0,15068,0,0,0,0,0,0,0,29295635,0,29295635,0,0,29295635,0,29295635
2020-08-11,442,442,440,442,85662,0.0,0,0,0,0,0,0,0,19421,0,19421,0,0,19421,0,19421,0,0,0,0,0,0,0,37777615,0,37777615,0,0,37777615,0,37777615
2020-08-12,439,442,437,442,199020,0.0,0,0,0,0,0,0,0,45121,0,45121,0,0,45121,0,45121,0,0,0,0,0,0,0,87604540,0,87604540,0,0,87604540,0,87604540
2020-08-13,442,442,439,442,186122,0.0,0,8995,-8995,0,0,0,8995,33202,0,42197,0,0,42197,0,42197,0,17495275,-17495275,0,0,0,17495275,64652495,0,82147770,0,0,82147770,0,82147770
2020-08-14,432,442,432,442,56528,0.0,0,0,0,0,0,0,0,12816,0,12816,0,0,12816,0,12816,0,0,0,0,0,0,0,24940335,0,24940335,0,0,24940335,0,24940335
2020-08-18,442,442,440,440,81679,-0.4524886877828055,0,0,0,0,0,0,0,18518,0,18518,0,0,18518,0,18518,0,0,0,0,0,0,0,36018170,0,36018170,0,0,36018170,0,36018170
2020-08-19,442,442,438,440,40261,0.0,0,0,0,0,0,0,0,9128,0,9128,0,0,9128,0,9128,0,0,0,0,0,0,0,17754995,0,17754995,0,0,17754995,0,17754995
2020-08-20,440,440,435,437,224889,-0.6818181818181818,0,6630,-6736,106,0,0,6630,44250,106,50986,0,0,50986,0,50986,0,12762750,-12966800,204050,0,0,12762750,85314705,204050,98281505,0,0,98281505,0,98281505
2020-08-21,440,440,435,439,205570,0.4576659038901602,0,0,0,0,0,0,0,46606,0,46606,0,0,46606,0,46606,0,0,0,0,0,0,0,89886515,0,89886515,0,0,89886515,0,89886515
2020-08-24,441,442,437,437,22856,-0.45558086560364464,0,0,3,-3,0,0,0,5182,0,5182,0,0,5179,3,5182,0,0,5730,-5730,0,0,0,10039900,0,10039900,0,0,10034170,5730,10039900
2020-08-25,441,441,435,439,270911,0.4576659038901602,0,0,0,0,0,0,0,61420,0,61420,0,0,61420,0,61420,0,0,0,0,0,0,0,118560295,0,118560295,0,0,118560295,0,118560295
2020-08-26,439,439,436,436,179458,-0.683371298405467,0,10374,-10374,0,0,0,10374,30312,0,40686,0,0,40686,0,40686,0,19969950,-19969950,0,0,0,19969950,58361785,0,78331735,0,0,78331735,0,78331735
2020-08-27,436,442,435,435,36609,-0.22935779816513763,0,0,0,0,0,0,0,8300,0,8300,0,0,8300,0,8300,0,0,0,0,0,0,0,15946520,0,15946520,0,0,15946520,0,15946520
2020-08-28,440,440,434,436,72707,0.22988505747126436,0,0,0,0,0,0,0,16484,0,16484,0,0,16484,0,16484,0,0,0,0,0,0,0,31669495,0,31669495,0,0,31669495,0,31669495
2020-08-31,439,439,433,436,21718,0.0,0,0,0,0,0,0,0,4924,0,4924,0,0,4924,0,4924,0,0,0,0,0,0,0,9476170,0,9476170,0,0,9476170,0,9476170
2020-09-01,440,440,433,437,41095,0.22935779816513763,0,0,0,0,0,0,0,9317,0,9317,0,0,9317,0,9317,0,0,0,0,0,0,0,17897025,0,17897025,0,0,17897025,0,17897025
2020-09-02,440,440,433,436,137326,-0.2288329519450801,0,0,0,0,0,0,0,31134,0,31134,0,0,31134,0,31134,0,0,0,0,0,0,0,59984885,0,59984885,0,0,59984885,0,59984885
2020-09-03,441,441,435,438,42581,0.45871559633027525,0,0,134,-134,0,0,0,9654,0,9654,0,0,9520,134,9654,0,0,259960,-259960,0,0,0,18596160,0,18596160,0,0,18336200,259960,18596160
2020-09-04,440,440,434,438,17669,0.0,0,0,0,0,0,0,0,4006,0,4006,0,0,4006,0,4006,0,0,0,0,0,0,0,7715560,0,7715560,0,0,7715560,0,7715560
2020-09-07,440,440,435,437,56820,-0.228310502283105,0,1,-135,134,0,0,1,12747,134,12882,0,0,12882,0,12882,0,1925,-260545,258620,0,0,1925,24545080,258620,24805625,0,0,24805625,0,24805625
2020-09-08,440,440,435,439,82385,0.4576659038901602,0,0,0,0,0,0,0,18678,0,18678,0,0,18678,0,18678,0,0,0,0,0,0,0,36091000,0,36091000,0,0,36091000,0,36091000
2020-09-09,435,439,434,439,224188,0.0,0,0,-178,178,0,0,0,50649,178,50827,0,0,50827,0,50827,0,0,-342650,342650,0,0,0,97486895,342650,97829545,0,0,97829545,0,97829545
2020-09-10,439,439,435,437,41285,-0.45558086560364464,0,0,0,0,0,0,0,9360,0,9360,0,0,9360,0,9360,0,0,0,0,0,0,0,18028670,0,18028670,0,0,18028670,0,18028670
2020-09-11,439,439,435,437,112290,0.0,0,0,0,0,0,0,0,25458,0,25458,0,0,25458,0,25458,0,0,0,0,0,0,0,49117180,0,49117180,0,0,49117180,0,49117180
2020-09-14,439,439,437,437,49886,0.0,0,0,0,0,0,0,0,11310,0,11310,0,0,11310,0,11310,0,0,0,0,0,0,0,21829825,0,21829825,0,0,21829825,0,21829825
2020-09-15,437,437,436,436,161241,-0.2288329519450801,0,0,0,0,0,0,0,36556,0,36556,0,0,36556,0,36556,0,0,0,0,0,0,0,70408980,0,70408980,0,0,70408980,0,70408980
2020-09-16,436,437,434,436,98003,0.0,0,0,0,0,0,0,0,22219,0,22219,0,0,22219,0,22219,0,0,0,0,0,0,0,42766595,0,42766595,0,0,42766595,0,42766595
2020-09-17,437,437,434,437,47142,0.22935779816513763,0,0,0,0,0,0,0,10688,0,10688,0,0,10688,0,10688,0,0,0,0,0,0,0,20575090,0,20575090,0,0,20575090,0,20575090
2020-09-18,435,448,434,438,127485,0.2288329519450801,0,2,-2,0,0,0,2,28901,0,28903,0,0,28903,0,28903,0,3850,-3850,0,0,0,3850,55849730,0,55853580,0,0,55853580,0,55853580
2020-09-21,438,438,433,437,85600,-0.228310502283105,0,1,-1,0,0,0,1,19406,0,19407,0,0,19407,0,19407,0,1915,-1915,0,0,0,1915,37181590,0,37183505,0,0,37183505,0,37183505
2020-09-22,438,438,436,436,20549,-0.2288329519450801,0,0,0,0,0,0,0,4659,0,4659,0,0,4659,0,4659,0,0,0,0,0,0,0,8972080,0,8972080,0,0,8972080,0,8972080
2020-09-23,438,448,435,437,18962,0.22935779816513763,0,0,0,0,0,0,0,4299,0,4299,0,0,4299,0,4299,0,0,0,0,0,0,0,8302950,0,8302950,0,0,8302950,0,8302950
2020-09-24,436,436,434,436,135764,-0.2288329519450801,0,0,875,-875,0,0,0,30755,25,30780,0,0,29880,900,30780,0,0,1684375,-1684375,0,0,0,59153375,48125,59201500,0,0,57469000,1732500,59201500
2020-09-25,436,436,435,435,86059,-0.22935779816513763,0,1,-1,0,0,0,1,19510,0,19511,0,0,19511,0,19511,0,1920,-1920,0,0,0,1920,37518510,0,37520430,0,0,37520430,0,37520430
2020-09-28,441,441,432,438,189307,0.6896551724137931,0,1,-1,0,0,0,1,42918,0,42919,0,0,42919,0,42919,0,1910,-1910,0,0,0,1910,82063425,0,82065335,0,0,82065335,0,82065335
2020-09-29,447,447,435,435,45638,-0.684931506849315,0,2,-2,0,0,0,2,10345,0,10347,0,0,10347,0,10347,0,3840,-3840,0,0,0,3840,19863665,0,19867505,0,0,19867505,0,19867505
2020-10-05,435,435,431,434,175735,-0.22988505747126436,0,2,-2,0,0,0,2,39840,0,39842,0,0,39842,0,39842,0,3820,-3820,0,0,0,3820,76151380,0,76155200,0,0,76155200,0,76155200
2020-10-06,438,438,435,435,68305,0.2304147465437788,0,0,0,0,0,0,0,15486,0,15486,0,0,15486,0,15486,0,0,0,0,0,0,0,29733875,0,29733875,0,0,29733875,0,29733875
2020-10-07,435,436,435,435,161647,0.0,0,0,0,0,0,0,0,36648,0,36648,0,0,36648,0,36648,0,0,0,0,0,0,0,70371725,0,70371725,0,0,70371725,0,70371725
2020-10-08,434,436,434,436,119480,0.22988505747126436,0,0,0,0,0,0,0,27088,0,27088,0,0,27088,0,27088,0,0,0,0,0,0,0,52009995,0,52009995,0,0,52009995,0,52009995
2020-10-12,437,437,434,436,91868,0.0,0,0,0,0,0,0,0,20828,0,20828,0,0,20828,0,20828,0,0,0,0,0,0,0,40049925,0,40049925,0,0,40049925,0,40049925
2020-10-13,437,437,434,436,289640,0.0,0,13200,-13200,0,0,0,13200,52466,0,65666,0,0,65666,0,65666,0,25410000,-25410000,0,0,0,25410000,100987115,0,126397115,0,0,126397115,0,126397115
2020-10-14,436,437,436,436,209063,0.0,-900,27000,-26100,0,0,0,27000,20398,0,47398,900,0,46498,0,47398,-1732500,52045000,-50312500,0,0,0,52045000,39294390,0,91339390,1732500,0,89606890,0,91339390
2020-10-15,437,437,436,436,36265,0.0,0,3000,-3000,0,0,0,3000,5222,0,8222,0,0,8222,0,8222,0,5790000,-5790000,0,0,0,5790000,10056035,0,15846035,0,0,15846035,0,15846035
2020-10-16,435,437,435,437,10016,0.22935779816513763,0,0,0,0,0,0,0,2271,0,2271,0,0,2271,0,2271,0,0,0,0,0,0,0,4377900,0,4377900,0,0,4377900,0,4377900
2020-10-19,435,437,435,437,84612,0.0,0,8000,-8000,0,0,0,8000,11183,0,19183,0,0,19183,0,19183,0,15400000,-15400000,0,0,0,15400000,21529765,0,36929765,0,0,36929765,0,36929765
2020-10-20,438,438,434,436,35167,-0.2288329519450801,0,0,0,0,0,0,0,7973,0,7973,0,0,7973,0,7973,0,0,0,0,0,0,0,15352655,0,15352655,0,0,15352655,0,15352655
2020-10-21,437,437,435,437,72275,0.22935779816513763,0,6000,-6000,0,0,0,6000,10386,0,16386,0,0,16386,0,16386,0,11550000,-11550000,0,0,0,11550000,19993370,0,31543370,0,0,31543370,0,31543370
2020-10-22,438,438,434,436,126158,-0.2288329519450801,0,15829,-15829,0,0,0,15829,12773,0,28602,0,0,28602,0,28602,0,30437680,-30437680,0,0,0,30437680,24563370,0,55001050,0,0,55001050,0,55001050
2020-10-23,436,437,434,436,60101,0.0,0,11332,-11347,15,0,0,11371,2240,15,13626,0,39,13587,0,13626,0,21810785,-21839660,28875,0,0,21885860,4312015,28875,26226750,0,75075,26151675,0,26226750
2020-10-26,436,436,435,435,145005,-0.22935779816513763,0,19735,-19736,1,0,0,19735,13139,1,32875,0,0,32875,0,32875,0,37921200,-37923125,1925,0,0,37921200,25227400,1925,63150525,0,0,63150525,0,63150525
2020-10-27,434,436,434,436,109202,0.22988505747126436,0,8000,-8003,3,0,0,8000,16755,3,24758,0,0,24758,0,24758,0,15360000,-15365775,5775,0,0,15360000,32171085,5775,47536860,0,0,47536860,0,47536860
2020-10-28,436,436,433,436,203025,0.0,0,0,0,0,0,0,0,46029,0,46029,0,0,46029,0,46029,0,0,0,0,0,0,0,88443350,0,88443350,0,0,88443350,0,88443350
2020-10-29,436,436,433,435,148670,-0.22935779816513763,0,1,-1,0,0,0,1,33705,0,33706,0,0,33706,0,33706,0,1915,-1915,0,0,0,1915,64597085,0,64599000,0,0,64599000,0,64599000
2020-10-30,433,435,433,435,118095,0.0,0,0,0,0,0,0,0,26774,0,26774,0,0,26774,0,26774,0,0,0,0,0,0,0,51371620,0,51371620,0,0,51371620,0,51371620
2020-11-02,435,436,432,435,89217,0.0,0,0,-1,1,0,0,0,20226,1,20227,0,0,20227,0,20227,0,0,-1925,1925,0,0,0,38724465,1925,38726390,0,0,38726390,0,38726390
2020-11-03,435,435,432,435,180075,0.0,0,1,-1,0,0,0,1,40825,0,40826,0,0,40826,0,40826,0,1915,-1915,0,0,0,1915,78292585,0,78294500,0,0,78294500,0,78294500
2020-11-04,435,435,433,433,219459,-0.45977011494252873,0,1,-1,0,0,0,1,49754,0,49755,0,0,49755,0,49755,0,1915,-1915,0,0,0,1915,95502775,0,95504690,0,0,95504690,0,95504690
2020-11-05,435,435,433,435,156398,0.4618937644341801,0,0,0,0,0,0,0,35458,0,35458,0,0,35458,0,35458,0,0,0,0,0,0,0,67971095,0,67971095,0,0,67971095,0,67971095
2020-11-06,433,435,433,435,121054,0.0,0,0,-2,2,0,0,0,27443,2,27445,0,0,27445,0,27445,0,0,-3835,3835,0,0,0,52554640,3835,52558475,0,0,52558475,0,52558475
2020-11-09,434,435,432,434,229238,-0.22988505747126436,0,9801,-9801,0,0,0,9801,42171,0,51972,0,0,51972,0,51972,0,18768915,-18768915,0,0,0,18768915,80686530,0,99455445,0,0,99455445,0,99455445
2020-11-10,434,435,434,434,83673,0.0,0,7000,-7000,0,0,0,7000,11970,0,18970,0,0,18970,0,18970,0,13405000,-13405000,0,0,0,13405000,22928085,0,36333085,0,0,36333085,0,36333085
2020-11-11,434,435,434,434,59991,0.0,0,0,0,0,0,0,0,13601,0,13601,0,0,13601,0,13601,0,0,0,0,0,0,0,26045955,0,26045955,0,0,26045955,0,26045955
2020-11-12,433,433,431,431,442973,-0.6912442396313364,0,12200,-12200,0,0,0,12200,88229,0,100429,0,0,100429,0,100429,0,23277000,-23277000,0,0,0,23277000,168271190,0,191548190,0,0,191548190,0,191548190
2020-11-13,434,434,431,433,164721,0.46403712296983757,0,18000,-18000,0,0,0,18000,19345,0,37345,0,0,37345,0,37345,0,34405000,-34405000,0,0,0,34405000,36853775,0,71258775,0,0,71258775,0,71258775
2020-11-16,431,434,431,433,400523,0.0,0,18000,-18000,0,0,0,18000,72805,0,90805,0,0,90805,0,90805,0,34340000,-34340000,0,0,0,34340000,138987730,0,173327730,0,0,173327730,0,173327730
2020-11-17,432,432,430,430,203320,-0.6928406466512702,0,13000,-13000,0,0,0,13000,33096,0,46096,0,0,46096,0,46096,0,24785955,-24785955,0,0,0,24785955,62955690,0,87741645,0,0,87741645,0,87741645
2020-11-18,431,432,430,430,259479,0.0,0,5000,-746,-4254,0,0,5000,53828,0,58828,0,0,54574,4254,58828,0,9500000,-1417400,-8082600,0,0,9500000,102275365,0,111775365,0,0,103692765,8082600,111775365
2020-11-19,429,432,429,431,66744,0.23255813953488372,0,11000,-11000,0,0,0,11000,4132,0,15132,0,0,15132,0,15132,0,20955000,-20955000,0,0,0,20955000,7860505,0,28815505,0,0,28815505,0,28815505
2020-11-20,433,433,431,433,17603,0.46403712296983757,0,0,0,0,0,0,0,3991,0,3991,0,0,3991,0,3991,0,0,0,0,0,0,0,7611270,0,7611270,0,0,7611270,0,7611270
2020-11-23,432,434,432,434,80748,0.23094688221709006,0,3000,-3000,0,0,0,3000,15307,0,18307,0,0,18307,0,18307,0,5730000,-5730000,0,0,0,5730000,29272770,0,35002770,0,0,35002770,0,35002770
2020-11-24,434,434,434,434,22693,0.0,0,5000,-5000,0,0,0,5000,145,0,5145,0,0,5145,0,5145,0,9575000,-9575000,0,0,0,9575000,277675,0,9852675,0,0,9852675,0,9852675
2020-11-25,433,433,429,431,149702,-0.6912442396313364,0,22159,-22137,-22,0,0,22159,11781,0,33940,0,0,33918,22,33940,0,42247895,-42205985,-41910,0,0,42247895,22460465,0,64708360,0,0,64666450,41910,64708360
2020-11-26,433,434,431,433,179912,0.46403712296983757,0,16844,-16844,0,0,0,16844,23945,0,40789,0,0,40789,0,40789,0,32142595,-32142595,0,0,0,32142595,45682240,0,77824835,0,0,77824835,0,77824835
2020-11-27,431,433,430,433,80184,0.0,0,5812,-5812,0,0,0,5812,12367,0,18179,0,0,18179,0,18179,0,11071860,-11071860,0,0,0,11071860,23546100,0,34617960,0,0,34617960,0,34617960
2020-11-30,432,432,431,431,228241,-0.4618937644341801,-1,12483,-12482,0,0,0,12483,39263,0,51746,1,0,51745,0,51746,-1905,23805115,-23803210,0,0,0,23805115,74951095,0,98756210,1905,0,98754305,0,98756210
2020-12-01,431,432,429,431,226645,0.0,0,11104,-11104,0,0,0,11104,40280,0,51384,0,0,51384,0,51384,0,21150975,-21150975,0,0,0,21150975,76719780,0,97870755,0,0,97870755,0,97870755
2020-12-02,431,433,431,433,89164,0.46403712296983757,0,10600,-10600,0,0,0,10600,9615,0,20215,0,0,20215,0,20215,0,20246000,-20246000,0,0,0,20246000,18317100,0,38563100,0,0,38563100,0,38563100
2020-12-03,434,434,431,433,145750,0.0,0,10000,-9727,-273,0,0,10000,23044,0,33044,0,0,32771,273,33044,0,19100000,-18577205,-522795,0,0,19100000,43982965,0,63082965,0,0,62560170,522795,63082965
2020-12-04,432,432,429,431,287351,-0.4618937644341801,0,25481,-25481,0,0,0,25481,39666,0,65147,0,0,65147,0,65147,0,48518900,-48518900,0,0,0,48518900,75518710,0,124037610,0,0,124037610,0,124037610
2020-12-07,431,432,428,430,213606,-0.23201856148491878,0,0,0,0,0,0,0,48428,0,48428,0,0,48428,0,48428,0,0,0,0,0,0,0,91984800,0,91984800,0,0,91984800,0,91984800
2020-12-08,432,432,429,431,86751,0.23255813953488372,0,320,-320,0,0,0,320,19348,0,19668,0,0,19668,0,19668,0,608000,-608000,0,0,0,608000,36858090,0,37466090,0,0,37466090,0,37466090
2020-12-09,432,432,431,431,118575,0.0,0,0,0,0,0,0,0,26883,0,26883,0,0,26883,0,26883,0,0,0,0,0,0,0,51212400,0,51212400,0,0,51212400,0,51212400
2020-12-10,432,432,428,431,100244,0.0,0,0,0,0,0,0,0,22727,0,22727,0,0,22727,0,22727,0,0,0,0,0,0,0,43153335,0,43153335,0,0,43153335,0,43153335
2020-12-11,432,432,428,428,384525,-0.6960556844547563,0,0,0,0,0,0,0,87178,0,87178,0,0,87178,0,87178,0,0,0,0,0,0,0,165226865,0,165226865,0,0,165226865,0,165226865
2020-12-14,432,432,429,429,172003,0.23364485981308408,0,0,0,0,0,0,0,38996,0,38996,0,0,38996,0,38996,0,0,0,0,0,0,0,73905370,0,73905370,0,0,73905370,0,73905370
2020-12-15,432,432,430,430,22199,0.2331002331002331,0,0,0,0,0,0,0,5033,0,5033,0,0,5033,0,5033,0,0,0,0,0,0,0,9563015,0,9563015,0,0,9563015,0,9563015
2020-12-16,432,432,430,430,124720,0.0,0,0,1000,-1000,0,0,0,28276,0,28276,0,0,27276,1000,28276,0,0,1905000,-1905000,0,0,0,53825980,0,53825980,0,0,51920980,1905000,53825980
2020-12-17,431,433,431,433,204088,0.6976744186046512,0,0,0,0,0,0,0,46270,0,46270,0,0,46270,0,46270,0,0,0,0,0,0,0,88334275,0,88334275,0,0,88334275,0,88334275
2020-12-18,432,433,430,430,265085,-0.6928406466512702,0,0,0,0,0,0,0,60099,0,60099,0,0,60099,0,60099,0,0,0,0,0,0,0,114265785,0,114265785,0,0,114265785,0,114265785
2020-12-21,430,433,430,433,88198,0.6976744186046512,0,0,0,0,0,0,0,19996,0,19996,0,0,19996,0,19996,0,0,0,0,0,0,0,38108890,0,38108890,0,0,38108890,0,38108890
2020-12-22,432,432,431,431,283800,-0.4618937644341801,0,0,0,0,0,0,0,64342,0,64342,0,0,64342,0,64342,0,0,0,0,0,0,0,122611360,0,122611360,0,0,122611360,0,122611360
2020-12-23,432,432,429,431,88273,0.0,0,0,0,0,0,0,0,20013,0,20013,0,0,20013,0,20013,0,0,0,0,0,0,0,38128270,0,38128270,0,0,38128270,0,38128270
2020-12-24,432,433,431,431,137436,0.0,0,-3000,3000,0,0,0,0,31159,0,31159,0,3000,28159,0,31159,0,-5745000,5745000,0,0,0,0,59419265,0,59419265,0,5745000,53674265,0,59419265
2020-12-28,432,434,431,434,57609,0.6960556844547563,0,0,0,0,0,0,0,13061,0,13061,0,0,13061,0,13061,0,0,0,0,0,0,0,24949650,0,24949650,0,0,24949650,0,24949650
2020-12-29,431,431,430,430,128059,-0.9216589861751152,0,2,-2,0,0,0,2,29031,0,29033,0,0,29033,0,29033,0,3800,-3800,0,0,0,3800,55174545,0,55178345,0,0,55178345,0,55178345
2020-12-30,431,431,428,430,88317,0.0,0,0,0,0,0,0,0,20023,0,20023,0,0,20023,0,20023,0,0,0,0,0,0,0,38027615,0,38027615,0,0,38027615,0,38027615
2021-01-04,430,430,427,429,195513,-0.23255813953488372,0,1,-501,500,0,0,1,43825,500,44326,0,0,44326,0,44326,0,1895,-949395,947500,0,0,1895,82942310,947500,83891705,0,0,83891705,0,83891705
2021-01-05,430,430,428,428,142328,-0.2331002331002331,0,0,0,0,0,0,0,32268,0,32268,0,0,32268,0,32268,0,0,0,0,0,0,0,61088460,0,61088460,0,0,61088460,0,61088460
2021-01-06,430,431,427,429,178606,0.23364485981308408,0,0,0,0,0,0,0,40493,0,40493,0,0,40493,0,40493,0,0,0,0,0,0,0,76761415,0,76761415,0,0,76761415,0,76761415
2021-01-07,432,432,428,431,296878,0.4662004662004662,0,0,0,0,0,0,0,67307,0,67307,0,0,67307,0,67307,0,0,0,0,0,0,0,128135685,0,128135685,0,0,128135685,0,128135685
2021-01-08,431,432,430,430,126422,-0.23201856148491878,0,0,0,0,0,0,0,28662,0,28662,0,0,28662,0,28662,0,0,0,0,0,0,0,54532995,0,54532995,0,0,54532995,0,54532995
2021-01-11,429,431,429,431,46503,0.23255813953488372,0,0,0,0,0,0,0,10543,0,10543,0,0,10543,0,10543,0,0,0,0,0,0,0,20052515,0,20052515,0,0,20052515,0,20052515
2021-01-12,432,432,429,429,227615,-0.46403712296983757,0,0,0,0,0,0,0,51604,0,51604,0,0,51604,0,51604,0,0,0,0,0,0,0,97938640,0,97938640,0,0,97938640,0,97938640
2021-01-13,430,432,428,430,72407,0.2331002331002331,0,-530,530,0,0,0,0,16416,0,16416,0,530,15886,0,16416,0,-1007000,1007000,0,0,0,0,31146960,0,31146960,0,1007000,30139960,0,31146960
2021-01-14,430,430,426,429,552361,-0.23255813953488372,0,0,0,0,0,0,0,125229,0,125229,0,0,125229,0,125229,0,0,0,0,0,0,0,236523120,0,236523120,0,0,236523120,0,236523120
2021-01-15,430,430,429,429,255809,0.0,0,0,500,-500,0,0,0,57996,0,57996,0,0,57496,500,57996,0,0,950000,-950000,0,0,0,110079345,0,110079345,0,0,109129345,950000,110079345
2021-01-18,429,431,429,431,1541745,0.4662004662004662,0,-330577,330577,0,0,0,0,349538,0,349538,0,330577,18961,0,349538,0,-629749185,629749185,0,0,0,0,665839285,0,665839285,0,629749185,36090100,0,665839285
2021-01-19,432,434,431,434,296587,0.6960556844547563,0,0,0,0,0,0,0,67241,0,67241,0,0,67241,0,67241,0,0,0,0,0,0,0,128591665,0,128591665,0,0,128591665,0,128591665
2021-01-20,434,434,429,431,231576,-0.6912442396313364,0,0,100,-100,0,0,0,52502,0,52502,0,0,52402,100,52502,0,0,190500,-190500,0,0,0,100097130,0,100097130,0,0,99906630,190500,100097130
2021-01-21,434,434,431,434,99644,0.6960556844547563,0,0,100,-100,0,0,0,22591,0,22591,0,0,22491,100,22591,0,0,191500,-191500,0,0,0,43256685,0,43256685,0,0,43065185,191500,43256685
2021-01-22,432,433,431,431,151207,-0.6912442396313364,0,1,-1,0,0,0,1,34280,0,34281,0,0,34281,0,34281,0,1910,-1910,0,0,0,1910,65385365,0,65387275,0,0,65387275,0,65387275
2021-01-25,433,433,431,433,164854,0.46403712296983757,0,0,0,0,0,0,0,37375,0,37375,0,0,37375,0,37375,0,0,0,0,0,0,0,71208160,0,71208160,0,0,71208160,0,71208160
2021-01-26,433,433,431,431,222203,-0.4618937644341801,0,0,0,0,0,0,0,50377,0,50377,0,0,50377,0,50377,0,0,0,0,0,0,0,96182405,0,96182405,0,0,96182405,0,96182405
2021-01-27,433,433,431,431,70348,0.0,0,0,0,0,0,0,0,15949,0,15949,0,0,15949,0,15949,0,0,0,0,0,0,0,30410650,0,30410650,0,0,30410650,0,30410650
2021-01-28,432,433,429,431,140837,0.0,0,0,0,0,0,0,0,31930,0,31930,0,0,31930,0,31930,0,0,0,0,0,0,0,60837425,0,60837425,0,0,60837425,0,60837425
2021-01-29,428,433,428,431,315884,0.0,0,0,0,0,0,0,0,71616,0,71616,0,0,71616,0,71616,0,0,0,0,0,0,0,136195980,0,136195980,0,0,136195980,0,136195980
2021-02-01,432,432,431,431,261256,0.0,0,0,0,0,0,0,0,59231,0,59231,0,0,59231,0,59231,0,0,0,0,0,0,0,112910230,0,112910230,0,0,112910230,0,112910230
2021-02-02,431,431,429,431,236172,0.0,0,0,0,0,0,0,0,53544,0,53544,0,0,53544,0,53544,0,0,0,0,0,0,0,101959930,0,101959930,0,0,101959930,0,101959930
2021-02-03,432,432,431,431,206659,0.0,0,0,0,0,0,0,0,46853,0,46853,0,0,46853,0,46853,0,0,0,0,0,0,0,89287370,0,89287370,0,0,89287370,0,89287370
2021-02-04,433,433,431,431,157016,0.0,0,-35253,35264,-11,0,0,0,35598,0,35598,0,35253,334,11,35598,0,-67156965,67177975,-21010,0,0,0,67814790,0,67814790,0,67156965,636815,21010,67814790
2021-02-05,432,435,432,434,34011,0.6960556844547563,0,0,89,-89,0,0,0,7711,0,7711,0,0,7622,89,7711,0,0,169990,-169990,0,0,0,14777335,0,14777335,0,0,14607345,169990,14777335
2021-02-08,435,436,434,434,35361,0.0,0,0,0,0,0,0,0,8017,0,8017,0,0,8017,0,8017,0,0,0,0,0,0,0,15359880,0,15359880,0,0,15359880,0,15359880
2021-02-09,434,434,433,433,140978,-0.2304147465437788,0,0,0,0,0,0,0,31962,0,31962,0,0,31962,0,31962,0,0,0,0,0,0,0,61074490,0,61074490,0,0,61074490,0,61074490
2021-02-10,434,434,433,433,60198,0.0,0,0,200,-200,0,0,0,13648,0,13648,0,0,13448,200,13648,0,0,383000,-383000,0,0,0,26085425,0,26085425,0,0,25702425,383000,26085425
2021-02-15,435,435,433,433,78375,0.0,0,0,0,0,0,0,0,17769,0,17769,0,0,17769,0,17769,0,0,0,0,0,0,0,33941310,0,33941310,0,0,33941310,0,33941310
2021-02-16,433,435,433,435,23505,0.4618937644341801,0,0,0,0,0,0,0,5329,0,5329,0,0,5329,0,5329,0,0,0,0,0,0,0,10212085,0,10212085,0,0,10212085,0,10212085
2021-02-17,436,436,433,435,61027,0.0,0,2,7049,-7051,0,0,2,13834,0,13836,0,0,6785,7051,13836,0,3830,13498835,-13502665,0,0,3830,26520420,0,26524250,0,0,13021585,13502665,26524250
2021-02-18,435,438,435,438,88150,0.6896551724137931,0,0,100,-100,0,0,0,19985,0,19985,0,0,19885,100,19985,0,0,193000,-193000,0,0,0,38545130,0,38545130,0,0,38352130,193000,38545130
2021-02-19,438,438,435,437,7705,-0.228310502283105,0,1,-1,0,0,0,1,1746,0,1747,0,0,1747,0,1747,0,1930,-1930,0,0,0,1930,3362270,0,3364200,0,0,3364200,0,3364200
2021-02-22,437,438,436,436,141167,-0.2288329519450801,0,0,0,0,0,0,0,32005,0,32005,0,0,32005,0,32005,0,0,0,0,0,0,0,61712155,0,61712155,0,0,61712155,0,61712155
2021-02-23,437,437,435,437,7908,0.22935779816513763,10,0,-10,0,0,10,0,1783,0,1793,0,0,1793,0,1793,19300,0,-19300,0,0,19300,0,3432920,0,3452220,0,0,3452220,0,3452220
2021-02-24,436,438,436,438,63612,0.2288329519450801,0,0,0,0,0,0,0,14422,0,14422,0,0,14422,0,14422,0,0,0,0,0,0,0,27840560,0,27840560,0,0,27840560,0,27840560
2021-02-25,438,438,437,437,47204,-0.228310502283105,0,0,0,0,0,0,0,10702,0,10702,0,0,10702,0,10702,0,0,0,0,0,0,0,20656950,0,20656950,0,0,20656950,0,20656950
2021-02-26,437,437,434,434,200630,-0.6864988558352403,0,0,0,0,0,0,0,45486,0,45486,0,0,45486,0,45486,0,0,0,0,0,0,0,87181995,0,87181995,0,0,87181995,0,87181995
2021-03-02,437,437,434,436,20876,0.4608294930875576,0,0,0,0,0,0,0,4733,0,4733,0,0,4733,0,4733,0,0,0,0,0,0,0,9110600,0,9110600,0,0,9110600,0,9110600
2021-03-03,437,437,435,437,107866,0.22935779816513763,0,0,0,0,0,0,0,24455,0,24455,0,0,24455,0,24455,0,0,0,0,0,0,0,47128690,0,47128690,0,0,47128690,0,47128690
2021-03-04,437,437,436,436,89371,-0.2288329519450801,0,7000,-7000,0,0,0,7000,13262,0,20262,0,0,20262,0,20262,0,13475000,-13475000,0,0,0,13475000,25531060,0,39006060,0,0,39006060,0,39006060
2021-03-05,435,438,435,437,65152,0.22935779816513763,0,3000,-3000,0,0,0,3000,11771,0,14771,0,0,14771,0,14771,0,5775000,-5775000,0,0,0,5775000,22681435,0,28456435,0,0,28456435,0,28456435
2021-03-08,436,438,436,438,26341,0.2288329519450801,0,0,0,0,0,0,0,5972,0,5972,0,0,5972,0,5972,0,0,0,0,0,0,0,11553460,0,11553460,0,0,11553460,0,11553460
2021-03-09,438,438,438,438,57543,0.0,0,2500,-2500,0,0,0,2500,10546,0,13046,0,0,13046,0,13046,0,4837500,-4837500,0,0,0,4837500,20406510,0,25244010,0,0,25244010,0,25244010
2021-03-10,437,439,437,439,42679,0.228310502283105,0,0,990,-990,0,0,0,9676,0,9676,0,0,8686,990,9676,0,0,1915650,-1915650,0,0,0,18728380,0,18728380,0,0,16812730,1915650,18728380
2021-03-11,441,441,438,440,33963,0.22779043280182232,0,0,0,0,0,0,0,7700,0,7700,0,0,7700,0,7700,0,0,0,0,0,0,0,14938315,0,14938315,0,0,14938315,0,14938315
2021-03-12,440,442,440,442,164911,0.45454545454545453,0,0,0,0,0,0,0,37388,0,37388,0,0,37388,0,37388,0,0,0,0,0,0,0,72876910,0,72876910,0,0,72876910,0,72876910
2021-03-15,443,444,440,443,85613,0.22624434389140274,0,1,-1,0,0,0,1,19409,0,19410,0,0,19410,0,19410,0,1950,-1950,0,0,0,1950,37931785,0,37933735,0,0,37933735,0,37933735
2021-03-16,444,444,443,443,38629,0.0,0,0,0,0,0,0,0,8758,0,8758,0,0,8758,0,8758,0,0,0,0,0,0,0,17147710,0,17147710,0,0,17147710,0,17147710
2021-03-17,443,446,443,443,129686,0.0,0,0,0,0,0,0,0,29402,0,29402,0,0,29402,0,29402,0,0,0,0,0,0,0,57668855,0,57668855,0,0,57668855,0,57668855
2021-03-18,445,445,443,445,19910,0.4514672686230248,0,0,100,-100,0,0,0,4514,0,4514,0,0,4414,100,4514,0,0,196500,-196500,0,0,0,8858970,0,8858970,0,0,8662470,196500,8858970
2021-03-19,444,446,442,442,400100,-0.6741573033707865,0,0,0,0,0,0,0,90709,0,90709,0,0,90709,0,90709,0,0,0,0,0,0,0,177039490,0,177039490,0,0,177039490,0,177039490
2021-03-22,444,444,442,442,63237,0.0,0,0,300,-300,0,0,0,14337,0,14337,0,0,14037,300,14337,0,0,585000,-585000,0,0,0,28000370,0,28000370,0,0,27415370,585000,28000370
2021-03-23,443,443,442,442,129157,0.0,0,0,0,0,0,0,0,29282,0,29282,0,0,29282,0,29282,0,0,0,0,0,0,0,57211965,0,57211965,0,0,57211965,0,57211965
2021-03-24,441,443,441,443,34302,0.22624434389140274,0,0,0,0,0,0,0,7777,0,7777,0,0,7777,0,7777,0,0,0,0,0,0,0,15167370,0,15167370,0,0,15167370,0,15167370
2021-03-25,442,444,442,444,10290,0.2257336343115124,0,0,0,0,0,0,0,2333,0,2333,0,0,2333,0,2333,0,0,0,0,0,0,0,4564780,0,4564780,0,0,4564780,0,4564780
2021-03-26,444,444,442,444,55660,0.0,0,0,0,0,0,0,0,12619,0,12619,0,0,12619,0,12619,0,0,0,0,0,0,0,24712945,0,24712945,0,0,24712945,0,24712945
2021-03-29,443,445,443,445,50530,0.22522522522522523,0,-7500,7500,0,0,0,0,11456,0,11456,0,7500,3956,0,11456,0,-14700000,14700000,0,0,0,0,22456505,0,22456505,0,14700000,7756505,0,22456505
2021-03-30,442,442,437,437,25181,-1.7977528089887642,0,0,0,0,0,0,0,5709,0,5709,0,0,5709,0,5709,0,0,0,0,0,0,0,11072370,0,11072370,0,0,11072370,0,11072370
2021-03-31,431,438,431,437,73603,0.0,0,-1000,1000,0,0,0,0,16687,0,16687,0,1000,15687,0,16687,0,-1930000,1930000,0,0,0,0,32193600,0,32193600,0,1930000,30263600,0,32193600
2021-04-01,439,439,437,439,60750,0.4576659038901602,0,-2000,2000,0,0,0,0,13773,0,13773,0,2000,11773,0,13773,0,-3880000,3880000,0,0,0,0,26711115,0,26711115,0,3880000,22831115,0,26711115
2021-04-02,439,440,439,439,118906,0.0,0,0,0,0,0,0,0,26958,0,26958,0,0,26958,0,26958,0,0,0,0,0,0,0,52298575,0,52298575,0,0,52298575,0,52298575
2021-04-05,441,441,438,440,69135,0.22779043280182232,0,-2000,2000,0,0,0,0,15674,0,15674,0,2000,13674,0,15674,0,-3890000,3890000,0,0,0,0,30459360,0,30459360,0,3890000,26569360,0,30459360
2021-04-06,441,441,438,440,60529,0.0,0,0,0,0,0,0,0,13723,0,13723,0,0,13723,0,13723,0,0,0,0,0,0,0,26633345,0,26633345,0,0,26633345,0,26633345
2021-04-07,439,440,435,438,212265,-0.45454545454545453,0,0,0,0,0,0,0,48124,0,48124,0,0,48124,0,48124,0,0,0,0,0,0,0,93179560,0,93179560,0,0,93179560,0,93179560
2021-04-08,437,440,437,439,23796,0.228310502283105,0,0,0,0,0,0,0,5395,0,5395,0,0,5395,0,5395,0,0,0,0,0,0,0,10460010,0,10460010,0,0,10460010,0,10460010
2021-04-09,441,441,438,440,15689,0.22779043280182232,0,0,0,0,0,0,0,3557,0,3557,0,0,3557,0,3557,0,0,0,0,0,0,0,6901865,0,6901865,0,0,6901865,0,6901865
2021-04-12,438,442,438,442,36459,0.45454545454545453,-20,0,20,0,0,0,0,8266,0,8266,20,0,8246,0,8266,-38800,0,38800,0,0,0,0,16094305,0,16094305,38800,0,16055505,0,16094305
2021-04-13,441,444,441,443,53066,0.22624434389140274,0,1,-1,0,0,0,1,12030,0,12031,0,0,12031,0,12031,0,1950,-1950,0,0,0,1950,23507620,0,23509570,0,0,23509570,0,23509570
2021-04-14,444,444,440,444,39798,0.2257336343115124,0,1,-1,0,0,0,1,9022,0,9023,0,0,9023,0,9023,0,1945,-1945,0,0,0,1945,17672115,0,17674060,0,0,17674060,0,17674060
2021-04-15,444,445,441,444,82552,0.0,0,1,-1,0,0,0,1,18715,0,18716,0,0,18716,0,18716,0,1955,-1955,0,0,0,1955,36583340,0,36585295,0,0,36585295,0,36585295
2021-04-16,444,444,441,444,80095,0.0,0,1,-1,0,0,0,1,18158,0,18159,0,0,18159,0,18159,0,1950,-1950,0,0,0,1950,35484765,0,35486715,0,0,35486715,0,35486715
2021-04-19,444,444,442,444,128411,0.0,0,0,10165,-10165,0,0,0,29113,0,29113,0,0,18948,10165,29113,0,0,19923400,-19923400,0,0,0,57029955,0,57029955,0,0,37106555,19923400,57029955
2021-04-20,443,445,443,445,152234,0.22522522522522523,0,0,0,0,0,0,0,34514,0,34514,0,0,34514,0,34514,0,0,0,0,0,0,0,67712530,0,67712530,0,0,67712530,0,67712530
2021-04-21,445,447,444,447,70299,0.44943820224719105,0,0,0,0,0,0,0,15938,0,15938,0,0,15938,0,15938,0,0,0,0,0,0,0,31392865,0,31392865,0,0,31392865,0,31392865
2021-04-22,448,448,446,448,49687,0.22371364653243847,0,0,0,0,0,0,0,11265,0,11265,0,0,11265,0,11265,0,0,0,0,0,0,0,22300595,0,22300595,0,0,22300595,0,22300595
2021-04-23,448,452,448,452,221078,0.8928571428571428,0,0,0,0,0,0,0,50122,0,50122,0,0,50122,0,50122,0,0,0,0,0,0,0,103456660,0,103456660,0,0,103456660,0,103456660
2021-04-26,452,452,448,452,143840,0.0,0,2,-2,0,0,0,2,32609,0,32611,0,0,32611,0,32611,0,3960,-3960,0,0,0,3960,64678310,0,64682270,0,0,64682270,0,64682270
2021-04-27,449,451,449,451,64269,-0.22123893805309736,0,1,-1,0,0,0,1,14570,0,14571,0,0,14571,0,14571,0,1985,-1985,0,0,0,1985,29499475,0,29501460,0,0,29501460,0,29501460
2021-04-28,450,450,445,445,95039,-1.3303769401330376,0,0,0,0,0,0,0,21547,0,21547,0,0,21547,0,21547,0,0,0,0,0,0,0,42645375,0,42645375,0,0,42645375,0,42645375
2021-04-29,448,448,445,445,87184,0.0,0,0,0,0,0,0,0,19766,0,19766,0,0,19766,0,19766,0,0,0,0,0,0,0,38970825,0,38970825,0,0,38970825,0,38970825
2021-04-30,444,446,444,446,14979,0.22471910112359553,0,0,0,0,0,0,0,3396,0,3396,0,0,3396,0,3396,0,0,0,0,0,0,0,6673875,0,6673875,0,0,6673875,0,6673875
2021-05-03,446,450,446,450,6761,0.8968609865470852,0,0,0,0,0,0,0,1533,0,1533,0,0,1533,0,1533,0,0,0,0,0,0,0,3020110,0,3020110,0,0,3020110,0,3020110
2021-05-04,451,451,448,451,56820,0.2222222222222222,0,0,0,0,0,0,0,12882,0,12882,0,0,12882,0,12882,0,0,0,0,0,0,0,25536025,0,25536025,0,0,25536025,0,25536025
2021-05-06,451,451,450,450,11498,-0.22172949002217296,0,1,-1,0,0,0,1,2606,0,2607,0,0,2607,0,2607,0,1985,-1985,0,0,0,1985,5174930,0,5176915,0,0,5176915,0,5176915
2021-05-07,451,451,449,451,11057,0.2222222222222222,0,0,0,0,0,0,0,2507,0,2507,0,0,2507,0,2507,0,0,0,0,0,0,0,4978640,0,4978640,0,0,4978640,0,4978640
2021-05-10,450,452,449,452,18304,0.22172949002217296,0,1,-1,0,0,0,1,4149,0,4150,0,0,4150,0,4150,0,1985,-1985,0,0,0,1985,8255105,0,8257090,0,0,8257090,0,8257090
2021-05-11,451,454,450,454,127622,0.4424778761061947,0,0,0,0,0,0,0,28934,0,28934,0,0,28934,0,28934,0,0,0,0,0,0,0,57890995,0,57890995,0,0,57890995,0,57890995
2021-05-12,452,452,445,445,35515,-1.9823788546255507,0,2,-2,0,0,0,2,8050,0,8052,0,0,8052,0,8052,0,3975,-3975,0,0,0,3975,15939345,0,15943320,0,0,15943320,0,15943320
2021-05-13,444,450,443,448,124759,0.6741573033707865,0,0,0,0,0,0,0,28285,0,28285,0,0,28285,0,28285,0,0,0,0,0,0,0,55582475,0,55582475,0,0,55582475,0,55582475
2021-05-14,450,450,447,447,127715,-0.2232142857142857,0,0,0,0,0,0,0,28955,0,28955,0,0,28955,0,28955,0,0,0,0,0,0,0,57290335,0,57290335,0,0,57290335,0,57290335
2021-05-17,452,452,446,448,185765,0.22371364653243847,0,0,0,0,0,0,0,42116,0,42116,0,0,42116,0,42116,0,0,0,0,0,0,0,83424360,0,83424360,0,0,83424360,0,83424360
2021-05-18,448,448,448,448,59051,0.0,0,1,-1,0,0,0,1,13387,0,13388,0,0,13388,0,13388,0,1980,-1980,0,0,0,1980,26506260,0,26508240,0,0,26508240,0,26508240
2021-05-20,451,451,448,451,56837,0.6696428571428571,0,0,0,0,0,0,0,12886,0,12886,0,0,12886,0,12886,0,0,0,0,0,0,0,25569660,0,25569660,0,0,25569660,0,25569660
2021-05-21,451,451,445,451,61098,0.0,0,0,0,0,0,0,0,13852,0,13852,0,0,13852,0,13852,0,0,0,0,0,0,0,27499545,0,27499545,0,0,27499545,0,27499545
2021-05-24,450,452,447,452,57627,0.22172949002217296,0,0,0,0,0,0,0,13065,0,13065,0,0,13065,0,13065,0,0,0,0,0,0,0,25869400,0,25869400,0,0,25869400,0,25869400
2021-05-25,452,452,450,452,2315,0.0,0,0,0,0,0,0,0,525,0,525,0,0,525,0,525,0,0,0,0,0,0,0,1045000,0,1045000,0,0,1045000,0,1045000
2021-05-26,447,451,447,451,46282,-0.22123893805309736,0,9001,-9001,0,0,0,9001,1492,0,10493,0,0,10493,0,10493,0,17776975,-17776975,0,0,0,17776975,2953095,0,20730070,0,0,20730070,0,20730070
2021-05-27,450,452,449,452,41867,0.22172949002217296,0,0,0,0,0,0,0,9492,0,9492,0,0,9492,0,9492,0,0,0,0,0,0,0,18889110,0,18889110,0,0,18889110,0,18889110
2021-05-28,452,452,448,450,158233,-0.4424778761061947,11,0,-11,0,0,11,0,35863,0,35874,0,0,35874,0,35874,21945,0,-21945,0,0,21945,0,71212510,0,71234455,0,0,71234455,0,71234455
2021-05-31,451,451,449,451,54927,0.2222222222222222,0,0,0,0,0,0,0,12453,0,12453,0,0,12453,0,12453,0,0,0,0,0,0,0,24721625,0,24721625,0,0,24721625,0,24721625
2021-06-01,451,452,450,450,71891,-0.22172949002217296,1000,0,-1000,0,0,1000,0,15299,0,16299,0,0,16299,0,16299,1990755,0,-1990755,0,0,1990755,0,30405460,0,32396215,0,0,32396215,0,32396215
2021-06-02,450,452,449,452,107976,0.4444444444444444,359,0,-359,0,0,359,0,24121,0,24480,0,0,24480,0,24480,715050,0,-715050,0,0,715050,0,48012175,0,48727225,0,0,48727225,0,48727225
2021-06-03,452,453,452,452,47217,0.0,1000,1,-1001,0,0,1000,1,9704,0,10705,0,0,10705,0,10705,1997250,1995,-1999245,0,0,1997250,1995,19359650,0,21358895,0,0,21358895,0,21358895
2021-06-04,451,453,450,453,130193,0.22123893805309736,1500,0,-1500,0,0,1500,0,28017,0,29517,0,0,29517,0,29517,2990890,0,-2990890,0,0,2990890,0,55816170,0,58807060,0,0,58807060,0,58807060
2021-06-07,453,453,451,453,58910,0.0,2000,0,-2000,0,0,2000,0,11356,0,13356,0,0,13356,0,13356,3997025,0,-3997025,0,0,3997025,0,22663100,0,26660125,0,0,26660125,0,26660125
2021-06-08,452,454,451,454,100059,0.22075055187637968,1500,0,-1500,0,0,1500,0,21185,0,22685,0,0,22685,0,22685,3005850,0,-3005850,0,0,3005850,0,42363125,0,45368975,0,0,45368975,0,45368975
2021-06-09,454,454,452,452,68398,-0.4405286343612335,2000,0,-2000,0,0,2000,0,13507,0,15507,0,0,15507,0,15507,4007630,0,-4007630,0,0,4007630,0,26960490,0,30968120,0,0,30968120,0,30968120
2021-06-10,453,453,450,452,226521,0.0,2000,10000,-12000,0,0,2000,10000,39356,0,51356,0,0,51356,0,51356,3987630,19944775,-23932405,0,0,3987630,19944775,78371410,0,102303815,0,0,102303815,0,102303815
2021-06-11,452,454,452,454,50415,0.4424778761061947,0,0,0,0,0,0,0,11430,0,11430,0,0,11430,0,11430,0,0,0,0,0,0,0,22864875,0,22864875,0,0,22864875,0,22864875
2021-06-14,455,455,452,455,54513,0.22026431718061676,2000,0,-2000,0,0,2000,0,10359,0,12359,0,0,12359,0,12359,4016645,0,-4016645,0,0,4016645,0,20725845,0,24742490,0,0,24742490,0,24742490
2021-06-15,455,455,453,455,46273,0.0,2000,0,-2000,0,0,2000,0,8491,0,10491,0,0,10491,0,10491,4018270,0,-4018270,0,0,4018270,0,17061860,0,21080130,0,0,21080130,0,21080130
2021-06-16,454,456,454,456,39247,0.21978021978021978,0,0,0,0,0,0,0,8898,0,8898,0,0,8898,0,8898,0,0,0,0,0,0,0,17916620,0,17916620,0,0,17916620,0,17916620
2021-06-17,455,457,454,457,157615,0.21929824561403508,0,0,0,0,0,0,0,35734,0,35734,0,0,35734,0,35734,0,0,0,0,0,0,0,72007755,0,72007755,0,0,72007755,0,72007755
2021-06-18,457,457,455,457,299449,0.0,3000,0,-3000,0,0,3000,0,64890,0,67890,0,0,67890,0,67890,6053995,0,-6053995,0,0,6053995,0,130863795,0,136917790,0,0,136917790,0,136917790
2021-06-21,457,457,456,456,177195,-0.2188183807439825,0,0,0,0,0,0,0,40173,0,40173,0,0,40173,0,40173,0,0,0,0,0,0,0,80961075,0,80961075,0,0,80961075,0,80961075
2021-06-22,455,457,455,457,200638,0.21929824561403508,0,0,0,0,0,0,0,45488,0,45488,0,0,45488,0,45488,0,0,0,0,0,0,0,91815005,0,91815005,0,0,91815005,0,91815005
2021-06-23,455,458,455,457,41620,0.0,0,-5000,5000,0,0,0,0,9436,0,9436,0,5000,4436,0,9436,0,-10125000,10125000,0,0,0,0,19090700,0,19090700,0,10125000,8965700,0,19090700
2021-06-24,457,458,454,456,220196,-0.2188183807439825,0,0,0,0,0,0,0,49922,0,49922,0,0,49922,0,49922,0,0,0,0,0,0,0,100483275,0,100483275,0,0,100483275,0,100483275
2021-06-25,458,458,455,457,73043,0.21929824561403508,0,-163,163,0,0,0,0,16560,0,16560,0,163,16397,0,16560,0,-329260,329260,0,0,0,0,33454560,0,33454560,0,329260,33125300,0,33454560
2021-06-28,459,459,456,459,134260,0.437636761487965,0,-10837,10837,0,0,0,0,30439,0,30439,0,10837,19602,0,30439,0,-21890740,21890740,0,0,0,0,61455280,0,61455280,0,21890740,39564540,0,61455280
2021-06-29,457,459,454,459,119118,0.0,0,-2997,2997,0,0,0,3,27003,0,27006,0,3000,24006,0,27006,0,-6053975,6053975,0,0,0,6025,54612240,0,54618265,0,6060000,48558265,0,54618265
2021-06-30,458,460,457,460,133440,0.2178649237472767,2500,1,-2501,0,0,2500,1,27752,0,30253,0,0,30253,0,30253,5061330,2020,-5063350,0,0,5061330,2020,56196795,0,61260145,0,0,61260145,0,61260145
2021-07-01,460,460,458,460,36869,0.0,0,0,0,0,0,0,0,8359,0,8359,0,0,8359,0,8359,0,0,0,0,0,0,0,16952775,0,16952775,0,0,16952775,0,16952775
2021-07-02,459,461,458,461,17277,0.21739130434782608,0,0,0,0,0,0,0,3917,0,3917,0,0,3917,0,3917,0,0,0,0,0,0,0,7950060,0,7950060,0,0,7950060,0,7950060
2021-07-05,461,461,459,461,21992,0.0,0,0,0,0,0,0,0,4986,0,4986,0,0,4986,0,4986,0,0,0,0,0,0,0,10123780,0,10123780,0,0,10123780,0,10123780
2021-07-06,461,461,458,460,51985,-0.21691973969631237,0,1,-1,0,0,0,1,11785,0,11786,0,0,11786,0,11786,0,2025,-2025,0,0,0,2025,23892125,0,23894150,0,0,23894150,0,23894150
2021-07-07,461,461,460,460,11379,0.0,0,0,0,0,0,0,0,2580,0,2580,0,0,2580,0,2580,0,0,0,0,0,0,0,5244615,0,5244615,0,0,5244615,0,5244615
2021-07-08,457,460,457,459,49074,-0.21739130434782608,0,1,-1,0,0,0,1,11125,0,11126,0,0,11126,0,11126,0,2025,-2025,0,0,0,2025,22484125,0,22486150,0,0,22486150,0,22486150
2021-07-09,459,459,457,457,27885,-0.4357298474945534,0,0,0,0,0,0,0,6322,0,6322,0,0,6322,0,6322,0,0,0,0,0,0,0,12791195,0,12791195,0,0,12791195,0,12791195
2021-07-12,457,459,456,459,208754,0.437636761487965,0,0,10000,-10000,0,0,0,47328,0,47328,0,0,37328,10000,47328,0,0,20150000,-20150000,0,0,0,95388905,0,95388905,0,0,75238905,20150000,95388905
2021-07-13,458,458,457,457,170940,-0.4357298474945534,0,0,0,0,0,0,0,38755,0,38755,0,0,38755,0,38755,0,0,0,0,0,0,0,78314730,0,78314730,0,0,78314730,0,78314730
2021-07-14,457,458,457,457,124230,0.0,0,0,0,0,0,0,0,28165,0,28165,0,0,28165,0,28165,0,0,0,0,0,0,0,56978010,0,56978010,0,0,56978010,0,56978010
2021-07-15,458,458,457,457,210655,0.0,0,-17626,17626,0,0,0,0,47759,0,47759,0,17626,30133,0,47759,0,-35604520,35604520,0,0,0,0,96623585,0,96623585,0,35604520,61019065,0,96623585
2021-07-16,459,459,457,459,15733,0.437636761487965,0,0,0,0,0,0,0,3567,0,3567,0,0,3567,0,3567,0,0,0,0,0,0,0,7212425,0,7212425,0,0,7212425,0,7212425
2021-07-19,459,459,457,459,269315,0.0,0,0,0,0,0,0,0,61058,0,61058,0,0,61058,0,61058,0,0,0,0,0,0,0,123337260,0,123337260,0,0,123337260,0,123337260
2021-07-20,458,458,455,457,287620,-0.4357298474945534,0,0,0,0,0,0,0,65208,0,65208,0,0,65208,0,65208,0,0,0,0,0,0,0,131662265,0,131662265,0,0,131662265,0,131662265
2021-07-21,457,458,457,457,166331,0.0,0,0,0,0,0,0,0,37710,0,37710,0,0,37710,0,37710,0,0,0,0,0,0,0,76174255,0,76174255,0,0,76174255,0,76174255
2021-07-22,457,457,455,457,53300,0.0,0,851,-851,0,0,0,851,11233,0,12084,0,0,12084,0,12084,0,1719020,-1719020,0,0,0,1719020,22675270,0,24394290,0,0,24394290,0,24394290
2021-07-23,455,460,455,459,29755,0.437636761487965,0,3459,-3459,0,0,0,3459,3287,0,6746,0,0,6746,0,6746,0,7004475,-7004475,0,0,0,7004475,6621400,0,13625875,0,0,13625875,0,13625875
2021-07-26,457,458,457,457,60383,-0.4357298474945534,0,1,-1,0,0,0,1,13689,0,13690,0,0,13690,0,13690,0,2020,-2020,0,0,0,2020,27653330,0,27655350,0,0,27655350,0,27655350
2021-07-27,455,457,455,457,108448,0.0,0,0,0,0,0,0,0,24587,0,24587,0,0,24587,0,24587,0,0,0,0,0,0,0,49551330,0,49551330,0,0,49551330,0,49551330
2021-07-28,457,458,455,457,147634,0.0,0,0,0,0,0,0,0,33471,0,33471,0,0,33471,0,33471,0,0,0,0,0,0,0,67578835,0,67578835,0,0,67578835,0,67578835
2021-07-29,459,459,459,459,225383,0.437636761487965,0,0,0,0,0,0,0,51098,0,51098,0,0,51098,0,51098,0,0,0,0,0,0,0,107719840,0,107719840,0,0,107719840,0,107719840
2021-07-30,460,460,458,460,238002,0.2178649237472767,0,0,0,0,0,0,0,53959,0,53959,0,0,53959,0,53959,0,0,0,0,0,0,0,109384305,0,109384305,0,0,109384305,0,109384305
2021-08-02,462,462,458,460,144105,0.0,610,0,-610,0,0,610,0,32061,0,32671,0,0,32671,0,32671,1237460,0,-1237460,0,0,1237460,0,65026975,0,66264435,0,0,66264435,0,66264435
2021-08-03,460,460,459,459,268922,-0.21739130434782608,0,0,0,0,0,0,0,60969,0,60969,0,0,60969,0,60969,0,0,0,0,0,0,0,123640225,0,123640225,0,0,123640225,0,123640225
2021-08-04,459,460,459,459,198530,0.0,0,0,0,0,0,0,0,45010,0,45010,0,0,45010,0,45010,0,0,0,0,0,0,0,91145350,0,91145350,0,0,91145350,0,91145350
2021-08-05,458,460,457,460,99997,0.2178649237472767,0,0,0,0,0,0,0,22671,0,22671,0,0,22671,0,22671,0,0,0,0,0,0,0,45908025,0,45908025,0,0,45908025,0,45908025
2021-08-06,459,460,459,459,267189,-0.21739130434782608,0,0,0,0,0,0,0,60576,0,60576,0,0,60576,0,60576,0,0,0,0,0,0,0,127437455,0,127437455,0,0,127437455,0,127437455
2021-08-09,462,462,457,459,175620,0.0,0,0,0,0,0,0,0,39816,0,39816,0,0,39816,0,39816,0,0,0,0,0,0,0,80706440,0,80706440,0,0,80706440,0,80706440
2021-08-10,461,461,459,459,99018,0.0,0,0,0,0,0,0,0,22449,0,22449,0,0,22449,0,22449,0,0,0,0,0,0,0,45460245,0,45460245,0,0,45460245,0,45460245
2021-08-11,459,460,459,459,94334,0.0,0,0,0,0,0,0,0,21387,0,21387,0,0,21387,0,21387,0,0,0,0,0,0,0,43364060,0,43364060,0,0,43364060,0,43364060
2021-08-12,487,487,459,459,292352,0.0,0,0,0,0,0,0,0,66281,0,66281,0,0,66281,0,66281,0,0,0,0,0,0,0,137806705,0,137806705,0,0,137806705,0,137806705
2021-08-13,459,460,459,459,36640,0.0,0,0,0,0,0,0,0,8307,0,8307,0,0,8307,0,8307,0,0,0,0,0,0,0,16829510,0,16829510,0,0,16829510,0,16829510
2021-08-17,457,459,457,459,132474,0.0,0,0,0,0,0,0,0,30034,0,30034,0,0,30034,0,30034,0,0,0,0,0,0,0,60763765,0,60763765,0,0,60763765,0,60763765
2021-08-18,458,460,458,460,64494,0.2178649237472767,0,0,0,0,0,0,0,14622,0,14622,0,0,14622,0,14622,0,0,0,0,0,0,0,29612085,0,29612085,0,0,29612085,0,29612085
2021-08-19,459,461,458,461,138865,0.21739130434782608,0,0,0,0,0,0,0,31483,0,31483,0,0,31483,0,31483,0,0,0,0,0,0,0,63946440,0,63946440,0,0,63946440,0,63946440
2021-08-20,458,461,458,460,56493,-0.21691973969631237,0,1,-1,0,0,0,1,12807,0,12808,0,0,12808,0,12808,0,2025,-2025,0,0,0,2025,25969995,0,25972020,0,0,25972020,0,25972020
2021-08-23,498,498,460,460,172074,0.0,0,0,0,0,0,0,0,39012,0,39012,0,0,39012,0,39012,0,0,0,0,0,0,0,83498355,0,83498355,0,0,83498355,0,83498355
2021-08-24,459,467,459,465,79218,1.0869565217391304,0,0,-150,150,0,0,0,17810,150,17960,0,0,17960,0,17960,0,0,-309000,309000,0,0,0,36253560,309000,36562560,0,0,36562560,0,36562560
2021-08-25,465,465,458,462,57067,-0.6451612903225806,0,4,-4,0,0,0,4,12934,0,12938,0,0,12938,0,12938,0,8145,-8145,0,0,0,8145,26209425,0,26217570,0,0,26217570,0,26217570
2021-08-26,462,462,458,460,30809,-0.4329004329004329,0,0,0,0,0,0,0,6985,0,6985,0,0,6985,0,6985,0,0,0,0,0,0,0,14146780,0,14146780,0,0,14146780,0,14146780
2021-08-27,459,461,459,461,58297,0.21739130434782608,0,0,0,0,0,0,0,13217,0,13217,0,0,13217,0,13217,0,0,0,0,0,0,0,26833690,0,26833690,0,0,26833690,0,26833690
2021-08-30,458,462,458,462,197621,0.21691973969631237,0,0,0,0,0,0,0,44804,0,44804,0,0,44804,0,44804,0,0,0,0,0,0,0,91198195,0,91198195,0,0,91198195,0,91198195
2021-08-31,462,463,461,461,106044,-0.21645021645021645,0,0,0,0,0,0,0,24042,0,24042,0,0,24042,0,24042,0,0,0,0,0,0,0,48996135,0,48996135,0,0,48996135,0,48996135
2021-09-01,463,463,461,461,47866,0.0,0,0,0,0,0,0,0,10852,0,10852,0,0,10852,0,10852,0,0,0,0,0,0,0,22090420,0,22090420,0,0,22090420,0,22090420
2021-09-02,460,462,460,462,89371,0.21691973969631237,-440,0,440,0,0,0,0,20262,0,20262,440,0,19822,0,20262,-897600,0,897600,0,0,0,0,41251600,0,41251600,897600,0,40354000,0,41251600
2021-09-03,462,463,460,462,47548,0.0,0,0,0,0,0,0,0,10780,0,10780,0,0,10780,0,10780,0,0,0,0,0,0,0,21950700,0,21950700,0,0,21950700,0,21950700
2021-09-06,462,463,460,462,21714,0.0,0,0,0,0,0,0,0,4923,0,4923,0,0,4923,0,4923,0,0,0,0,0,0,0,10030890,0,10030890,0,0,10030890,0,10030890
2021-09-07,462,462,460,462,39406,0.0,-117,0,117,0,0,0,0,8934,0,8934,117,0,8817,0,8934,-238680,0,238680,0,0,0,0,18187690,0,18187690,238680,0,17949010,0,18187690
2021-09-08,462,463,460,462,6955,0.0,0,0,0,0,0,0,0,1577,0,1577,0,0,1577,0,1577,0,0,0,0,0,0,0,3222025,0,3222025,0,0,3222025,0,3222025
2021-09-09,459,462,459,462,46657,0.0,1,0,-1,0,0,1,0,10577,0,10578,0,0,10578,0,10578,2040,0,-2040,0,0,2040,0,21544305,0,21546345,0,0,21546345,0,21546345
2021-09-10,463,463,459,461,61583,-0.21645021645021645,0,0,0,0,0,0,0,13962,0,13962,0,0,13962,0,13962,0,0,0,0,0,0,0,28415120,0,28415120,0,0,28415120,0,28415120
2021-09-13,462,462,458,462,87453,0.21691973969631237,0,0,0,0,0,0,0,19827,0,19827,0,0,19827,0,19827,0,0,0,0,0,0,0,40191380,0,40191380,0,0,40191380,0,40191380
2021-09-14,461,463,460,463,59272,0.21645021645021645,0,0,0,0,0,0,0,13438,0,13438,0,0,13438,0,13438,0,0,0,0,0,0,0,27402335,0,27402335,0,0,27402335,0,27402335
2021-09-15,463,463,460,463,132055,0.0,0,0,0,0,0,0,0,29939,0,29939,0,0,29939,0,29939,0,0,0,0,0,0,0,61077755,0,61077755,0,0,61077755,0,61077755
2021-09-16,463,464,463,463,19067,0.0,15,0,-15,0,0,15,0,4308,0,4323,0,0,4323,0,4323,30675,0,-30675,0,0,30675,0,8815105,0,8845780,0,0,8845780,0,8845780
2021-09-17,462,464,461,464,17625,0.21598272138228944,0,0,0,0,0,0,0,3996,0,3996,0,0,3996,0,3996,0,0,0,0,0,0,0,8164655,0,8164655,0,0,8164655,0,8164655
2021-09-23,466,466,461,463,55704,-0.21551724137931033,0,0,0,0,0,0,0,12629,0,12629,0,0,12629,0,12629,0,0,0,0,0,0,0,25832500,0,25832500,0,0,25832500,0,25832500
2021-09-24,465,465,463,465,13924,0.4319654427645789,0,0,0,0,0,0,0,3157,0,3157,0,0,3157,0,3157,0,0,0,0,0,0,0,6476410,0,6476410,0,0,6476410,0,6476410
2021-09-27,467,467,462,465,350028,0.0,953,1,-954,0,0,953,1,78403,0,79357,0,0,79357,0,79357,1948885,2045,-1950930,0,0,1948885,2045,160502710,0,162453640,0,0,162453640,0,162453640
2021-09-28,464,467,464,467,20276,0.43010752688172044,0,0,0,0,0,0,0,4597,0,4597,0,0,4597,0,4597,0,0,0,0,0,0,0,9448065,0,9448065,0,0,9448065,0,9448065
2021-09-29,466,466,461,464,180962,-0.6423982869379015,0,2,-2,0,0,0,2,41025,0,41027,0,0,41027,0,41027,0,4090,-4090,0,0,0,4090,84046340,0,84050430,0,0,84050430,0,84050430
2021-09-30,463,465,461,465,26257,0.21551724137931033,0,0,150,-150,0,0,0,5953,0,5953,0,0,5803,150,5953,0,0,308250,-308250,0,0,0,12208750,0,12208750,0,0,11900500,308250,12208750
2021-10-01,464,465,462,464,179109,-0.21505376344086022,7000,0,-7000,0,0,7000,0,33607,0,40607,0,0,40607,0,40607,14315000,0,-14315000,0,0,14315000,0,68876710,0,83191710,0,0,83191710,0,83191710
2021-10-05,464,465,453,460,716955,-0.8620689655172413,13700,0,-13700,0,0,13700,0,148845,0,162545,0,0,162545,0,162545,27600500,0,-27600500,0,0,27600500,0,300594430,0,328194930,0,0,328194930,0,328194930
2021-10-06,463,464,460,460,44977,0.0,805,0,-805,0,0,805,0,9392,0,10197,0,0,10197,0,10197,1634150,0,-1634150,0,0,1634150,0,19086610,0,20720760,0,0,20720760,0,20720760
2021-10-07,464,464,460,463,43989,0.6521739130434783,0,0,0,0,0,0,0,9973,0,9973,0,0,9973,0,9973,0,0,0,0,0,0,0,20307200,0,20307200,0,0,20307200,0,20307200
2021-10-08,463,467,463,467,173759,0.8639308855291578,-15,0,15,0,0,0,0,39394,0,39394,15,0,39379,0,39394,-30825,0,30825,0,0,0,0,80988335,0,80988335,30825,0,80957510,0,80988335
2021-10-12,466,467,465,465,207378,-0.4282655246252677,-21454,0,21454,0,0,1005,0,46011,0,47016,22459,0,24557,0,47016,-44190220,0,44190220,0,0,2075320,0,94723770,0,96799090,46265540,0,50533550,0,96799090
2021-10-13,462,466,461,464,249621,-0.21505376344086022,0,1,-1,0,0,0,1,56592,0,56593,0,0,56593,0,56593,0,2050,-2050,0,0,0,2050,115511095,0,115513145,0,0,115513145,0,115513145
2021-10-14,466,468,466,468,69236,0.8620689655172413,324,0,-324,0,0,324,0,15373,0,15697,0,0,15697,0,15697,669060,0,-669060,0,0,669060,0,31729265,0,32398325,0,0,32398325,0,32398325
2021-10-15,467,473,467,473,156182,1.0683760683760684,1800,0,-1800,0,0,1800,0,33609,0,35409,0,0,35409,0,35409,3762000,0,-3762000,0,0,3762000,0,70089185,0,73851185,0,0,73851185,0,73851185
2021-10-18,471,474,470,473,71662,0.0,0,0,0,0,0,0,0,16247,0,16247,0,0,16247,0,16247,0,0,0,0,0,0,0,33961320,0,33961320,0,0,33961320,0,33961320
2021-10-19,474,474,473,473,133766,0.0,0,0,0,0,0,0,0,30327,0,30327,0,0,30327,0,30327,0,0,0,0,0,0,0,63460540,0,63460540,0,0,63460540,0,63460540
2021-10-20,473,473,471,471,51588,-0.42283298097251587,0,0,0,0,0,0,0,11696,0,11696,0,0,11696,0,11696,0,0,0,0,0,0,0,24372140,0,24372140,0,0,24372140,0,24372140
2021-10-21,474,474,465,470,52700,-0.21231422505307856,0,0,0,0,0,0,0,11948,0,11948,0,0,11948,0,11948,0,0,0,0,0,0,0,24725900,0,24725900,0,0,24725900,0,24725900
2021-10-22,469,469,467,469,171108,-0.2127659574468085,0,2,-2,0,0,0,2,38791,0,38793,0,0,38793,0,38793,0,4135,-4135,0,0,0,4135,80197450,0,80201585,0,0,80201585,0,80201585
2021-10-25,471,473,470,470,59629,0.21321961620469082,0,0,0,0,0,0,0,13519,0,13519,0,0,13519,0,13519,0,0,0,0,0,0,0,28122505,0,28122505,0,0,28122505,0,28122505
2021-10-26,477,477,470,470,77237,0.0,0,0,0,0,0,0,0,17511,0,17511,0,0,17511,0,17511,0,0,0,0,0,0,0,36390385,0,36390385,0,0,36390385,0,36390385
2021-10-27,473,473,471,471,66329,0.2127659574468085,0,0,0,0,0,0,0,15038,0,15038,0,0,15038,0,15038,0,0,0,0,0,0,0,31301675,0,31301675,0,0,31301675,0,31301675
2021-10-28,470,474,470,474,278908,0.6369426751592357,0,100,-100,0,0,0,100,63133,0,63233,0,0,63233,0,63233,0,208000,-208000,0,0,0,208000,131411420,0,131619420,0,0,131619420,0,131619420
2021-10-29,474,478,474,478,61138,0.8438818565400843,0,0,0,0,0,0,0,13861,0,13861,0,0,13861,0,13861,0,0,0,0,0,0,0,29186170,0,29186170,0,0,29186170,0,29186170
2021-11-01,478,482,473,476,37681,-0.41841004184100417,0,0,0,0,0,0,0,8543,0,8543,0,0,8543,0,8543,0,0,0,0,0,0,0,18149945,0,18149945,0,0,18149945,0,18149945
2021-11-02,480,480,475,478,46145,0.42016806722689076,-4,0,4,0,0,0,0,10462,0,10462,4,0,10458,0,10462,-8400,0,8400,0,0,0,0,22010880,0,22010880,8400,0,22002480,0,22010880
2021-11-03,479,483,477,482,75327,0.8368200836820083,0,0,0,0,0,0,0,17078,0,17078,0,0,17078,0,17078,0,0,0,0,0,0,0,36376145,0,36376145,0,0,36376145,0,36376145
2021-11-04,481,481,479,481,27594,-0.2074688796680498,0,0,0,0,0,0,0,6256,0,6256,0,0,6256,0,6256,0,0,0,0,0,0,0,13270465,0,13270465,0,0,13270465,0,13270465
2021-11-05,481,481,480,480,62183,-0.2079002079002079,0,1,-1,0,0,0,1,14097,0,14098,0,0,14098,0,14098,0,2120,-2120,0,0,0,2120,29903475,0,29905595,0,0,29905595,0,29905595
2021-11-08,479,482,479,482,246978,0.4166666666666667,0,0,0,0,0,0,0,55994,0,55994,0,0,55994,0,55994,0,0,0,0,0,0,0,119002325,0,119002325,0,0,119002325,0,119002325
2021-11-09,481,482,481,481,47760,-0.2074688796680498,0,0,0,0,0,0,0,10828,0,10828,0,0,10828,0,10828,0,0,0,0,0,0,0,23022980,0,23022980,0,0,23022980,0,23022980
2021-11-10,485,485,481,484,41611,0.6237006237006237,0,0,0,0,0,0,0,9434,0,9434,0,0,9434,0,9434,0,0,0,0,0,0,0,20111120,0,20111120,0,0,20111120,0,20111120
2021-11-11,484,486,483,486,35656,0.4132231404958678,0,0,0,0,0,0,0,8084,0,8084,0,0,8084,0,8084,0,0,0,0,0,0,0,17307160,0,17307160,0,0,17307160,0,17307160
2021-11-12,487,487,486,486,46362,0.0,0,0,0,0,0,0,0,10511,0,10511,0,0,10511,0,10511,0,0,0,0,0,0,0,22566365,0,22566365,0,0,22566365,0,22566365
2021-11-15,487,487,484,487,67353,0.205761316872428,-1324,0,1324,0,0,0,0,15270,0,15270,1324,0,13946,0,15270,-2833360,0,2833360,0,0,0,0,32711495,0,32711495,2833360,0,29878135,0,32711495
2021-11-16,485,487,483,485,47028,-0.41067761806981523,0,1,-1,0,0,0,1,10661,0,10662,0,0,10662,0,10662,0,2135,-2135,0,0,0,2135,22800420,0,22802555,0,0,22802555,0,22802555
2021-11-17,485,485,484,484,45475,-0.2061855670103093,0,0,0,0,0,0,0,10310,0,10310,0,0,10310,0,10310,0,0,0,0,0,0,0,22015440,0,22015440,0,0,22015440,0,22015440
2021-11-18,483,484,482,482,663849,-0.4132231404958678,0,0,0,0,0,0,0,150505,0,150505,0,0,150505,0,150505,0,0,0,0,0,0,0,320872130,0,320872130,0,0,320872130,0,320872130
2021-11-19,482,484,482,484,95348,0.4149377593360996,0,0,0,0,0,0,0,21617,0,21617,0,0,21617,0,21617,0,0,0,0,0,0,0,46044215,0,46044215,0,0,46044215,0,46044215
2021-11-22,482,482,482,482,130361,-0.4132231404958678,0,0,0,0,0,0,0,29555,0,29555,0,0,29555,0,29555,0,0,0,0,0,0,0,62952150,0,62952150,0,0,62952150,0,62952150
2021-11-23,484,484,481,484,71287,0.4149377593360996,0,0,0,0,0,0,0,16162,0,16162,0,0,16162,0,16162,0,0,0,0,0,0,0,34429645,0,34429645,0,0,34429645,0,34429645
2021-11-24,486,486,484,484,71014,0.0,0,0,0,0,0,0,0,16100,0,16100,0,0,16100,0,16100,0,0,0,0,0,0,0,34378615,0,34378615,0,0,34378615,0,34378615
2021-11-25,482,485,482,484,37002,0.0,0,0,0,0,0,0,0,8389,0,8389,0,0,8389,0,8389,0,0,0,0,0,0,0,17912300,0,17912300,0,0,17912300,0,17912300
2021-11-26,484,485,484,484,25543,0.0,0,0,0,0,0,0,0,5791,0,5791,0,0,5791,0,5791,0,0,0,0,0,0,0,12370585,0,12370585,0,0,12370585,0,12370585
2021-11-29,483,483,481,481,129338,-0.6198347107438017,0,1,-1,0,0,0,1,29322,0,29323,0,0,29323,0,29323,0,2130,-2130,0,0,0,2130,62367520,0,62369650,0,0,62369650,0,62369650
2021-11-30,481,482,481,481,18759,0.0,-50,0,50,0,0,0,0,4253,0,4253,50,0,4203,0,4253,-106250,0,106250,0,0,0,0,9037675,0,9037675,106250,0,8931425,0,9037675
2021-12-01,481,481,478,481,99865,0.0,-25,0,25,0,0,0,0,22641,0,22641,25,0,22616,0,22641,-53000,0,53000,0,0,0,0,47978915,0,47978915,53000,0,47925915,0,47978915
2021-12-02,479,481,479,481,18097,0.0,0,0,0,0,0,0,0,4103,0,4103,0,0,4103,0,4103,0,0,0,0,0,0,0,8698720,0,8698720,0,0,8698720,0,8698720
2021-12-03,479,484,479,482,30593,0.2079002079002079,-15,0,15,0,0,0,0,6936,0,6936,15,0,6921,0,6936,-31800,0,31800,0,0,0,0,14716975,0,14716975,31800,0,14685175,0,14716975
2021-12-06,480,482,480,482,26072,0.0,0,0,0,0,0,0,0,5911,0,5911,0,0,5911,0,5911,0,0,0,0,0,0,0,12586430,0,12586430,0,0,12586430,0,12586430
2021-12-07,480,482,480,482,103826,0.0,0,0,0,0,0,0,0,23539,0,23539,0,0,23539,0,23539,0,0,0,0,0,0,0,50056935,0,50056935,0,0,50056935,0,50056935
2021-12-08,480,483,480,482,36711,0.0,300,0,-300,0,0,300,0,8023,0,8323,0,0,8323,0,8323,639000,0,-639000,0,0,639000,0,17094715,0,17733715,0,0,17733715,0,17733715
2021-12-09,486,486,481,485,17899,0.6224066390041494,0,0,0,0,0,0,0,4058,0,4058,0,0,4058,0,4058,0,0,0,0,0,0,0,8663315,0,8663315,0,0,8663315,0,8663315
2021-12-10,486,486,481,484,38823,-0.2061855670103093,0,0,0,0,0,0,0,8802,0,8802,0,0,8802,0,8802,0,0,0,0,0,0,0,18730155,0,18730155,0,0,18730155,0,18730155
2021-12-13,480,483,480,482,31091,-0.4132231404958678,-312,1,311,0,0,0,1,7048,0,7049,312,0,6737,0,7049,-664720,2125,662595,0,0,0,2125,15019020,0,15021145,664720,0,14356425,0,15021145
2021-12-14,482,483,481,481,70224,-0.2074688796680498,0,0,0,0,0,0,0,15921,0,15921,0,0,15921,0,15921,0,0,0,0,0,0,0,33924135,0,33924135,0,0,33924135,0,33924135
2021-12-15,481,482,481,481,96018,0.0,0,0,0,0,0,0,0,21769,0,21769,0,0,21769,0,21769,0,0,0,0,0,0,0,46334860,0,46334860,0,0,46334860,0,46334860
2021-12-16,481,484,481,484,19385,0.6237006237006237,0,0,0,0,0,0,0,4395,0,4395,0,0,4395,0,4395,0,0,0,0,0,0,0,9374140,0,9374140,0,0,9374140,0,9374140
2021-12-17,482,484,482,484,71900,0.0,0,0,0,0,0,0,0,16301,0,16301,0,0,16301,0,16301,0,0,0,0,0,0,0,34726990,0,34726990,0,0,34726990,0,34726990
2021-12-20,482,483,480,482,43693,-0.4132231404958678,0,1,-1,0,0,0,1,9905,0,9906,0,0,9906,0,9906,0,2130,-2130,0,0,0,2130,21080765,0,21082895,0,0,21082895,0,21082895
2021-12-21,482,483,479,482,147819,0.0,0,0,0,0,0,0,0,33513,0,33513,0,0,33513,0,33513,0,0,0,0,0,0,0,71107125,0,71107125,0,0,71107125,0,71107125
2021-12-22,481,484,480,484,140409,0.4149377593360996,0,0,0,0,0,0,0,31833,0,31833,0,0,31833,0,31833,0,0,0,0,0,0,0,67536985,0,67536985,0,0,67536985,0,67536985
2021-12-23,483,485,482,485,101660,0.2066115702479339,0,1,-1,0,0,0,1,23047,0,23048,0,0,23048,0,23048,0,2130,-2130,0,0,0,2130,49205330,0,49207460,0,0,49207460,0,49207460
2021-12-24,482,485,482,485,135522,0.0,0,0,-6,6,0,0,0,30719,6,30725,0,0,30725,0,30725,0,0,-12815,12815,0,0,0,65633985,12815,65646800,0,0,65646800,0,65646800
2021-12-27,486,486,483,485,40614,0.0,0,0,0,0,0,0,0,9208,0,9208,0,0,9208,0,9208,0,0,0,0,0,0,0,19663475,0,19663475,0,0,19663475,0,19663475
2021-12-28,485,486,485,485,84678,0.0,0,0,0,0,0,0,0,19198,0,19198,0,0,19198,0,19198,0,0,0,0,0,0,0,41087870,0,41087870,0,0,41087870,0,41087870
2021-12-29,481,483,480,480,77528,-1.0309278350515463,0,1,-1,0,0,0,1,17576,0,17577,0,0,17577,0,17577,0,2125,-2125,0,0,0,2125,37280440,0,37282565,0,0,37282565,0,37282565
2021-12-30,481,484,480,484,66184,0.8333333333333334,0,0,0,0,0,0,0,15005,0,15005,0,0,15005,0,15005,0,0,0,0,0,0,0,31884145,0,31884145,0,0,31884145,0,31884145
2022-01-03,480,483,479,482,75005,-0.4132231404958678,0,1,-1,0,0,0,1,17004,0,17005,0,0,17005,0,17005,0,2125,-2125,0,0,0,2125,36059015,0,36061140,0,0,36061140,0,36061140
2022-01-04,482,484,482,484,124543,0.4149377593360996,0,0,0,0,0,0,0,28236,0,28236,0,0,28236,0,28236,0,0,0,0,0,0,0,60260660,0,60260660,0,0,60260660,0,60260660
2022-01-05,483,485,483,485,54583,0.2066115702479339,0,0,0,0,0,0,0,12375,0,12375,0,0,12375,0,12375,0,0,0,0,0,0,0,26421870,0,26421870,0,0,26421870,0,26421870
2022-01-06,485,485,482,485,3572,0.0,0,0,0,0,0,0,0,810,0,810,0,0,810,0,810,0,0,0,0,0,0,0,1725340,0,1725340,0,0,1725340,0,1725340
2022-01-07,484,486,483,486,178368,0.2061855670103093,0,0,0,0,0,0,0,40439,0,40439,0,0,40439,0,40439,0,0,0,0,0,0,0,86434750,0,86434750,0,0,86434750,0,86434750
2022-01-10,487,488,487,487,996278,0.205761316872428,0,0,0,0,0,0,0,225872,0,225872,0,0,225872,0,225872,0,0,0,0,0,0,0,486558270,0,486558270,0,0,486558270,0,486558270
2022-01-11,486,489,485,489,101267,0.41067761806981523,0,0,0,0,0,0,0,22959,0,22959,0,0,22959,0,22959,0,0,0,0,0,0,0,49361905,0,49361905,0,0,49361905,0,49361905
2022-01-12,483,487,483,487,34148,-0.408997955010225,-1810,0,1808,2,0,0,0,7740,2,7742,1810,0,5932,0,7742,-3891500,0,3887215,4285,0,0,0,16578275,4285,16582560,3891500,0,12691060,0,16582560
2022-01-13,486,490,486,488,18229,0.20533880903490762,0,0,0,0,0,0,0,4133,0,4133,0,0,4133,0,4133,0,0,0,0,0,0,0,8895100,0,8895100,0,0,8895100,0,8895100
2022-01-14,489,489,485,487,60494,-0.20491803278688525,0,1,-1,0,0,0,1,13714,0,13715,0,0,13715,0,13715,0,2145,-2145,0,0,0,2145,29503180,0,29505325,0,0,29505325,0,29505325
2022-01-17,486,489,486,488,28921,0.20533880903490762,0,0,0,0,0,0,0,6557,0,6557,0,0,6557,0,6557,0,0,0,0,0,0,0,14127780,0,14127780,0,0,14127780,0,14127780
2022-01-18,489,489,483,487,153738,-0.20491803278688525,0,0,0,0,0,0,0,34855,0,34855,0,0,34855,0,34855,0,0,0,0,0,0,0,74879880,0,74879880,0,0,74879880,0,74879880
2022-01-19,486,489,486,489,183229,0.41067761806981523,0,0,0,0,0,0,0,41541,0,41541,0,0,41541,0,41541,0,0,0,0,0,0,0,89340475,0,89340475,0,0,89340475,0,89340475
2022-01-20,489,489,487,487,46556,-0.408997955010225,0,1,-1,0,0,0,1,10554,0,10555,0,0,10555,0,10555,0,2155,-2155,0,0,0,2155,22730305,0,22732460,0,0,22732460,0,22732460
2022-01-21,487,489,487,487,165233,0.0,0,0,-5,5,0,0,0,37456,5,37461,0,0,37461,0,37461,0,0,-10770,10770,0,0,0,80535710,10770,80546480,0,0,80546480,0,80546480
2022-01-24,487,487,482,486,212151,-0.20533880903490762,9493,2,-9495,0,0,9493,2,38603,0,48098,0,0,48098,0,48098,20361530,4260,-20365790,0,0,20361530,4260,82635640,0,103001430,0,0,103001430,0,103001430
2022-01-25,483,483,482,482,426931,-0.823045267489712,4914,1,-4915,0,0,4914,1,91877,0,96792,0,0,96792,0,96792,10490520,2135,-10492655,0,0,10490520,2135,195845765,0,206338420,0,0,206338420,0,206338420
2022-01-26,482,483,482,482,111769,0.0,0,0,0,0,0,0,0,25340,0,25340,0,0,25340,0,25340,0,0,0,0,0,0,0,53999200,0,53999200,0,0,53999200,0,53999200
2022-01-27,482,488,481,485,157055,0.6224066390041494,0,0,0,0,0,0,0,35607,0,35607,0,0,35607,0,35607,0,0,0,0,0,0,0,75881795,0,75881795,0,0,75881795,0,75881795
2022-01-28,489,489,485,485,96429,0.0,9388,0,-9388,0,0,9388,0,12474,0,21862,0,0,21862,0,21862,20090320,0,-20090320,0,0,20090320,0,26728800,0,46819120,0,0,46819120,0,46819120
2022-02-03,487,489,486,489,42418,0.8247422680412372,0,0,-7,7,0,0,0,9610,7,9617,0,0,9617,0,9617,0,0,-15080,15080,0,0,0,20722850,15080,20737930,0,0,20737930,0,20737930
2022-02-04,490,490,486,489,317309,0.0,18949,0,-18949,0,0,18949,0,52990,0,71939,0,0,71939,0,71939,40856830,0,-40856830,0,0,40856830,0,114105465,0,154962295,0,0,154962295,0,154962295
2022-02-07,490,491,488,490,71812,0.2044989775051125,1085,0,-1085,0,0,1085,0,15196,0,16281,0,0,16281,0,16281,2343600,0,-2343600,0,0,2343600,0,32903965,0,35247565,0,0,35247565,0,35247565
2022-02-08,489,492,489,491,38634,0.20408163265306123,10,0,-10,0,0,10,0,8749,0,8759,0,0,8759,0,8759,21650,0,-21650,0,0,21650,0,19009985,0,19031635,0,0,19031635,0,19031635
2022-02-09,493,494,493,493,93928,0.40733197556008144,0,0,0,0,0,0,0,21295,0,21295,0,0,21295,0,21295,0,0,0,0,0,0,0,46333345,0,46333345,0,0,46333345,0,46333345
2022-02-10,494,495,492,494,53617,0.2028397565922921,4597,0,-4597,0,0,4597,0,7559,0,12156,0,0,12156,0,12156,9998475,0,-9998475,0,0,9998475,0,16466595,0,26465070,0,0,26465070,0,26465070
2022-02-11,496,496,494,494,111333,0.0,0,0,0,0,0,0,0,25241,0,25241,0,0,25241,0,25241,0,0,0,0,0,0,0,55040080,0,55040080,0,0,55040080,0,55040080
2022-02-14,496,496,493,495,238752,0.20242914979757085,0,0,0,0,0,0,0,54129,0,54129,0,0,54129,0,54129,0,0,0,0,0,0,0,118261955,0,118261955,0,0,118261955,0,118261955
2022-02-15,495,496,495,495,29336,0.0,0,0,0,0,0,0,0,6651,0,6651,0,0,6651,0,6651,0,0,0,0,0,0,0,14539475,0,14539475,0,0,14539475,0,14539475
2022-02-16,496,496,495,495,4027,0.0,0,0,0,0,0,0,0,913,0,913,0,0,913,0,913,0,0,0,0,0,0,0,1999260,0,1999260,0,0,1999260,0,1999260
2022-02-17,496,496,496,496,18132,0.20202020202020202,0,0,0,0,0,0,0,4111,0,4111,0,0,4111,0,4111,0,0,0,0,0,0,0,9003090,0,9003090,0,0,9003090,0,9003090
2022-02-18,495,497,495,497,141485,0.20161290322580644,0,0,0,0,0,0,0,32077,0,32077,0,0,32077,0,32077,0,0,0,0,0,0,0,70348850,0,70348850,0,0,70348850,0,70348850
2022-02-21,498,498,496,498,62479,0.2012072434607646,0,0,0,0,0,0,0,14165,0,14165,0,0,14165,0,14165,0,0,0,0,0,0,0,31162550,0,31162550,0,0,31162550,0,31162550
2022-02-22,498,499,496,498,37430,0.0,0,0,2,-2,0,0,0,8486,0,8486,0,0,8484,2,8486,0,0,4395,-4395,0,0,0,18639240,0,18639240,0,0,18634845,4395,18639240
2022-02-23,498,498,498,498,113102,0.0,0,0,0,0,0,0,0,25642,0,25642,0,0,25642,0,25642,0,0,0,0,0,0,0,56412620,0,56412620,0,0,56412620,0,56412620
2022-02-24,496,498,496,496,427010,-0.4016064257028112,0,0,0,0,0,0,0,96810,0,96810,0,0,96810,0,96810,0,0,0,0,0,0,0,212087560,0,212087560,0,0,212087560,0,212087560
2022-02-25,498,499,496,498,132452,0.4032258064516129,-15,0,15,0,0,0,0,30029,0,30029,15,0,30014,0,30029,-33075,0,33075,0,0,0,0,66012240,0,66012240,33075,0,65979165,0,66012240
2022-02-28,498,498,495,498,96195,0.0,-1000,1,983,16,0,0,1,21792,16,21809,1000,0,20809,0,21809,-2200000,2190,2162690,35120,0,0,2190,47803065,35120,47840375,2200000,0,45640375,0,47840375
2022-03-02,499,499,498,498,98625,0.0,-8165,0,8165,0,0,0,0,22360,0,22360,8165,0,14195,0,22360,-17973825,0,17973825,0,0,0,0,49215725,0,49215725,17973825,0,31241900,0,49215725
2022-03-03,499,499,497,499,92075,0.2008032128514056,-4880,0,4880,0,0,0,0,20875,0,20875,4880,0,15995,0,20875,-10760400,0,10760400,0,0,0,0,46029325,0,46029325,10760400,0,35268925,0,46029325
2022-03-04,499,501,499,501,93072,0.4008016032064128,-2999,0,2999,0,0,1,0,21100,0,21101,3000,0,18101,0,21101,-6627795,0,6627795,0,0,2205,0,46577310,0,46579515,6630000,0,39949515,0,46579515
2022-03-07,503,503,502,502,66241,0.19960079840319359,-584,0,584,0,0,0,0,15018,0,15018,584,0,14434,0,15018,-1296480,0,1296480,0,0,0,0,33270395,0,33270395,1296480,0,31973915,0,33270395
2022-03-08,502,503,502,502,238673,0.0,-45000,0,45000,0,0,0,0,54111,0,54111,45000,0,9111,0,54111,-99695000,0,99695000,0,0,0,0,119904365,0,119904365,99695000,0,20209365,0,119904365
2022-03-10,502,502,501,501,854193,-0.199203187250996,-182015,0,182015,0,0,0,0,193659,0,193659,182015,0,11644,0,193659,-403163225,0,403163225,0,0,0,0,428915025,0,428915025,403163225,0,25751800,0,428915025
2022-03-11,501,502,501,501,77198,0.0,-3000,0,3000,0,0,0,0,17502,0,17502,3000,0,14502,0,17502,-6645000,0,6645000,0,0,0,0,38740540,0,38740540,6645000,0,32095540,0,38740540
2022-03-14,500,500,496,499,321640,-0.39920159680638717,-37000,2,36998,0,0,0,2,72919,0,72921,37000,0,35921,0,72921,-81595000,4390,81590610,0,0,0,4390,160653600,0,160657990,81595000,0,79062990,0,160657990
2022-03-15,499,500,496,499,47447,0.0,-3686,0,3686,0,0,0,0,10757,0,10757,3686,0,7071,0,10757,-8128115,0,8128115,0,0,0,0,23660425,0,23660425,8128115,0,15532310,0,23660425
2022-03-16,497,499,497,499,99428,0.0,-7976,0,7976,0,0,0,0,22542,0,22542,7976,0,14566,0,22542,-17587080,0,17587080,0,0,0,0,49697575,0,49697575,17587080,0,32110495,0,49697575
2022-03-17,499,499,499,499,172348,0.0,-33000,1000,32000,0,0,0,1000,38074,0,39074,33000,0,6074,0,39074,-72765000,2205000,70560000,0,0,0,2205000,83953170,0,86158170,72765000,0,13393170,0,86158170
2022-03-18,500,500,497,499,225604,0.0,-21740,0,21740,0,0,4260,0,46888,0,51148,26000,0,25148,0,51148,-47961700,0,47961700,0,0,9393300,0,103349910,0,112743210,57355000,0,55388210,0,112743210
2022-03-21,499,500,499,499,302700,0.0,-64695,0,64695,0,0,1,0,68626,0,68627,64696,0,3931,0,68627,-142667965,0,142667965,0,0,2205,0,151345335,0,151347540,142670170,0,8677370,0,151347540
2022-03-22,499,500,498,498,79204,-0.2004008016032064,-10024,0,10014,10,0,0,0,17947,10,17957,10024,0,7933,0,17957,-22103040,0,22080975,22065,0,0,0,39535840,22065,39557905,22103040,0,17454865,0,39557905
2022-03-23,501,501,498,498,89058,0.0,-19823,0,19823,0,0,0,0,20191,0,20191,19823,0,368,0,20191,-43709805,0,43709805,0,0,0,0,44521230,0,44521230,43709805,0,811425,0,44521230
2022-03-24,499,501,499,501,40301,0.6024096385542169,-8000,0,8000,0,0,0,0,9137,0,9137,8000,0,1137,0,9137,-17640000,0,17640000,0,0,0,0,20147150,0,20147150,17640000,0,2507150,0,20147150
2022-03-25,501,501,499,501,170235,0.0,-34045,0,34045,0,0,0,0,38595,0,38595,34045,0,4550,0,38595,-75199450,0,75199450,0,0,0,0,85239735,0,85239735,75199450,0,10040285,0,85239735
2022-03-28,501,501,499,499,410117,-0.39920159680638717,-92000,0,92003,-3,0,0,0,92980,0,92980,92000,0,977,3,92980,-202860000,0,202866615,-6615,0,0,0,205020910,0,205020910,202860000,0,2154295,6615,205020910
2022-03-29,499,501,499,501,62157,0.4008016032064128,-14000,0,14000,0,0,0,0,14092,0,14092,14000,0,92,0,14092,-30870000,0,30870000,0,0,0,0,31072930,0,31072930,30870000,0,202930,0,31072930
2022-03-30,497,499,496,499,131556,-0.39920159680638717,-16133,2,16131,0,0,0,2,29824,0,29826,16133,0,13693,0,29826,-35573265,4400,35568865,0,0,0,4400,65702970,0,65707370,35573265,0,30134105,0,65707370
2022-03-31,498,499,498,498,47777,-0.2004008016032064,-10183,0,10183,0,0,0,0,10832,0,10832,10183,0,649,0,10832,-22402715,0,22402715,0,0,0,0,23830525,0,23830525,22402715,0,1427810,0,23830525
2022-04-01,499,499,498,498,49242,0.0,-8817,0,8817,0,0,0,0,11164,0,11164,8817,0,2347,0,11164,-19397500,0,19397500,0,0,0,0,24560900,0,24560900,19397500,0,5163400,0,24560900
2022-04-04,498,499,496,498,347227,0.0,-53818,0,53818,0,0,8192,0,70530,0,78722,62010,0,16712,0,78722,-118399650,0,118399650,0,0,18022400,0,155097090,0,173119490,136422050,0,36697440,0,173119490
2022-04-05,498,499,498,498,101161,0.0,-18177,0,18177,0,0,0,0,22935,0,22935,18177,0,4758,0,22935,-39989905,0,39989905,0,0,0,0,50458000,0,50458000,39989905,0,10468095,0,50458000
2022-04-06,496,498,496,498,71803,0.0,-6014,0,6014,0,0,0,0,16279,0,16279,6014,0,10265,0,16279,-13230800,0,13230800,0,0,0,0,35763810,0,35763810,13230800,0,22533010,0,35763810
2022-04-07,497,498,497,497,29927,-0.2008032128514056,-5000,0,5000,0,0,0,0,6785,0,6785,5000,0,1785,0,6785,-10975000,0,10975000,0,0,0,0,14893180,0,14893180,10975000,0,3918180,0,14893180
2022-04-08,497,497,496,496,190313,-0.2012072434607646,-25000,0,25001,-1,0,0,0,43147,0,43147,25000,0,18146,1,43147,-54875000,0,54877195,-2195,0,0,0,94645555,0,94645555,54875000,0,39768360,2195,94645555
2022-04-11,496,498,496,496,85587,0.0,228,0,-228,0,0,228,0,19176,0,19404,0,0,19404,0,19404,501600,0,-501600,0,0,501600,0,42033905,0,42535505,0,0,42535505,0,42535505
2022-04-12,497,497,495,497,97518,0.20161290322580644,0,0,0,0,0,0,0,22109,0,22109,0,0,22109,0,22109,0,0,0,0,0,0,0,48462490,0,48462490,0,0,48462490,0,48462490
2022-04-13,499,499,497,497,59651,0.0,-7302,0,7302,0,0,0,0,13524,0,13524,7302,0,6222,0,13524,-16027890,0,16027890,0,0,0,0,29685255,0,29685255,16027890,0,13657365,0,29685255
2022-04-14,502,502,496,496,440313,-0.2012072434607646,-1000,0,1000,0,0,0,0,99826,0,99826,1000,0,98826,0,99826,-2190030,0,2190030,0,0,0,0,218624220,0,218624220,2190030,0,216434190,0,218624220
2022-04-15,503,503,495,497,207427,0.20161290322580644,6000,0,-6000,0,0,6000,0,41027,0,47027,0,0,47027,0,47027,13177800,0,-13177800,0,0,13177800,0,89891290,0,103069090,0,0,103069090,0,103069090
2022-04-18,501,501,494,496,183061,-0.2012072434607646,4019,0,-4019,0,0,6019,0,35484,0,41503,2000,0,39503,0,41503,8814730,0,-8814730,0,0,13204730,0,77678110,0,90882840,4390000,0,86492840,0,90882840
2022-04-19,496,496,494,494,381049,-0.4032258064516129,6000,1,-6001,0,0,6000,1,80389,0,86390,0,0,86390,0,86390,13123425,2180,-13125605,0,0,13123425,2180,175527305,0,188652910,0,0,188652910,0,188652910
2022-04-20,491,493,491,491,405662,-0.6072874493927125,6000,2,-6006,4,0,6000,2,85964,4,91970,0,0,91970,0,91970,13045905,4345,-13058940,8690,0,13045905,4345,186763800,8690,199822740,0,0,199822740,0,199822740
2022-04-21,492,497,492,496,76311,1.0183299389002036,5162,0,-5299,137,0,6354,0,10810,137,17301,1192,0,16109,0,17301,11292615,0,-11593330,300715,0,13909055,0,23547400,300715,37757170,2616440,0,35140730,0,37757170
2022-04-22,500,500,496,496,39101,0.0,4000,0,-4000,0,0,6000,0,2865,0,8865,2000,0,6865,0,8865,8769855,0,-8769855,0,0,13159855,0,6276170,0,19436025,4390000,0,15046025,0,19436025
2022-04-25,497,497,493,495,63696,-0.20161290322580644,5338,0,-5338,0,0,6000,0,8441,0,14441,662,0,13779,0,14441,11678815,0,-11678815,0,0,13131905,0,18425755,0,31557660,1453090,0,30104570,0,31557660
2022-04-26,494,497,494,497,36274,0.40404040404040403,4000,0,-4000,0,0,6000,0,2224,0,8224,2000,0,6224,0,8224,8769030,0,-8769030,0,0,13159030,0,4866970,0,18026000,4390000,0,13636000,0,18026000
2022-04-27,497,497,496,496,40614,-0.2012072434607646,-3033,0,3033,0,0,0,0,9208,0,9208,3033,0,6175,0,9208,-6657435,0,6657435,0,0,0,0,20191000,0,20191000,6657435,0,13533565,0,20191000
2022-04-28,494,498,494,496,76686,0.0,-2000,0,2000,0,0,0,0,17386,0,17386,2000,0,15386,0,17386,-4400000,0,4400000,0,0,0,0,38152245,0,38152245,4400000,0,33752245,0,38152245
2022-04-29,498,498,495,497,44597,0.20161290322580644,-8668,0,8668,0,0,0,0,10111,0,10111,8668,0,1443,0,10111,-19026260,0,19026260,0,0,0,0,22193450,0,22193450,19026260,0,3167190,0,22193450
2022-05-02,497,497,496,496,16941,-0.2012072434607646,-11,0,11,0,0,3000,0,841,0,3841,3011,0,830,0,3841,-24145,0,24145,0,0,6585000,0,1841845,0,8426845,6609145,0,1817700,0,8426845
2022-05-03,495,497,495,497,51924,0.20161290322580644,-2000,0,2000,0,0,0,0,11772,0,11772,2000,0,9772,0,11772,-4390000,0,4390000,0,0,0,0,25806395,0,25806395,4390000,0,21416395,0,25806395
2022-05-04,499,499,496,498,38621,0.2012072434607646,0,0,0,0,0,0,0,8756,0,8756,0,0,8756,0,8756,0,0,0,0,0,0,0,19219470,0,19219470,0,0,19219470,0,19219470
2022-05-06,498,498,497,497,131367,-0.2008032128514056,-6518,0,6518,0,0,3000,0,26783,0,29783,9518,0,20265,0,29783,-14306000,0,14306000,0,0,6588600,0,58788710,0,65377310,20894600,0,44482710,0,65377310
2022-05-09,497,497,495,497,34219,0.0,0,0,8,-8,0,0,0,7758,0,7758,0,0,7750,8,7758,0,0,17550,-17550,0,0,0,17003540,0,17003540,0,0,16985990,17550,17003540
2022-05-10,496,496,494,494,55862,-0.6036217303822937,0,2,-2,0,0,0,2,12663,0,12665,0,0,12665,0,12665,0,4370,-4370,0,0,0,4370,27667185,0,27671555,0,0,27671555,0,27671555
2022-05-11,498,498,496,498,15927,0.8097165991902834,3000,0,-2998,-2,0,3000,0,611,0,3611,0,0,3609,2,3611,6596345,0,-6591945,-4400,0,6596345,0,1343525,0,7939870,0,0,7935470,4400,7939870
2022-05-12,495,497,494,494,49427,-0.8032128514056224,-4311,4,4307,0,0,0,4,11202,0,11206,4311,0,6895,0,11206,-9445145,8750,9436395,0,0,0,8750,24523940,0,24532690,9445145,0,15087545,0,24532690
2022-05-13,494,496,494,496,44465,0.4048582995951417,0,0,3,-3,0,0,0,10081,0,10081,0,0,10078,3,10081,0,0,6555,-6555,0,0,0,22026990,0,22026990,0,0,22020435,6555,22026990
2022-05-16,496,496,494,496,23716,0.0,0,0,0,0,0,0,0,5377,0,5377,0,0,5377,0,5377,0,0,0,0,0,0,0,11762215,0,11762215,0,0,11762215,0,11762215
2022-05-17,498,498,496,498,143373,0.4032258064516129,-5000,0,5001,-1,0,3000,0,29505,0,32505,8000,0,24504,1,32505,-11001460,0,11003660,-2200,0,6598540,0,64911000,0,71509540,17600000,0,53907340,2200,71509540
2022-05-18,500,500,497,497,81013,-0.2008032128514056,-13146,0,13010,136,0,3000,0,15231,136,18367,16146,0,2221,0,18367,-28866275,0,28566395,299880,0,6607965,0,33453600,299880,40361445,35474240,0,4887205,0,40361445
2022-05-19,498,498,495,497,62020,0.0,-12001,0,12001,0,0,0,0,14061,0,14061,12001,0,2060,0,14061,-26282195,0,26282195,0,0,0,0,30794155,0,30794155,26282195,0,4511960,0,30794155
2022-05-20,498,498,496,498,42559,0.2012072434607646,-4000,0,4000,0,0,3000,0,6649,0,9649,7000,0,2649,0,9649,-8778760,0,8778760,0,0,6596240,0,14601560,0,21197800,15375000,0,5822800,0,21197800
2022-05-23,496,498,495,498,190313,0.0,-19002,0,19002,0,0,3000,0,40147,0,43147,22002,0,21145,0,43147,-41712000,0,41712000,0,0,6592400,0,88191240,0,94783640,48304400,0,46479240,0,94783640
2022-05-24,498,498,495,497,81666,-0.2008032128514056,3000,1,-3001,0,0,3000,1,15514,0,18515,0,0,18515,0,18515,6581820,2190,-6584010,0,0,6581820,2190,34001440,0,40585450,0,0,40585450,0,40585450
2022-05-25,497,497,496,496,8014,-0.2012072434607646,-1816,0,1816,0,0,0,0,1817,0,1817,1816,0,1,0,1817,-3986120,0,3986120,0,0,0,0,3988310,0,3988310,3986120,0,2190,0,3988310
2022-05-26,495,498,495,497,37694,0.20161290322580644,-3500,0,3501,-1,0,0,0,8546,0,8546,3500,0,5045,1,8546,-7682500,0,7684690,-2190,0,0,0,18738365,0,18738365,7682500,0,11053675,2190,18738365
2022-05-27,495,498,495,498,2695,0.2012072434607646,0,0,0,0,0,0,0,611,0,611,0,0,611,0,611,0,0,0,0,0,0,0,1338100,0,1338100,0,0,1338100,0,1338100
2022-05-30,498,498,497,497,31069,-0.2008032128514056,-4000,0,4003,-3,0,0,0,7044,0,7044,4000,0,3041,3,7044,-8780000,0,8786595,-6595,0,0,0,15461670,0,15461670,8780000,0,6675075,6595,15461670
2022-05-31,496,497,494,496,75945,-0.2012072434607646,0,1,-1,0,0,0,1,17217,0,17218,0,0,17218,0,17218,0,2190,-2190,0,0,0,2190,37654550,0,37656740,0,0,37656740,0,37656740
2022-06-02,496,496,495,495,41990,-0.20161290322580644,3000,0,-3000,0,0,3000,0,6520,0,9520,0,0,9520,0,9520,6567540,0,-6567540,0,0,6567540,0,14252520,0,20820060,0,0,20820060,0,20820060
2022-06-03,498,498,494,494,77528,-0.20202020202020202,3000,0,-3000,0,0,3000,0,14577,0,17577,0,0,17577,0,17577,6585550,0,-6585550,0,0,6585550,0,31778900,0,38364450,0,0,38364450,0,38364450
2022-06-07,498,498,494,494,74405,0.0,0,0,0,0,0,0,0,16869,0,16869,0,0,16869,0,16869,0,0,0,0,0,0,0,36800580,0,36800580,0,0,36800580,0,36800580
2022-06-08,494,494,493,493,106790,-0.20242914979757085,0,0,0,0,0,0,0,24211,0,24211,0,0,24211,0,24211,0,0,0,0,0,0,0,52727730,0,52727730,0,0,52727730,0,52727730
2022-06-09,493,494,491,493,54416,0.0,0,0,0,0,0,0,0,12337,0,12337,0,0,12337,0,12337,0,0,0,0,0,0,0,26825820,0,26825820,0,0,26825820,0,26825820
2022-06-10,496,496,492,495,29362,0.4056795131845842,0,0,0,0,0,0,0,6657,0,6657,0,0,6657,0,6657,0,0,0,0,0,0,0,14533115,0,14533115,0,0,14533115,0,14533115
2022-06-13,498,498,494,494,50706,-0.20202020202020202,0,0,0,0,0,0,0,11496,0,11496,0,0,11496,0,11496,0,0,0,0,0,0,0,25092230,0,25092230,0,0,25092230,0,25092230
2022-06-14,497,497,492,494,31462,0.0,0,0,1,-1,0,0,0,7133,0,7133,0,0,7132,1,7133,0,0,2195,-2195,0,0,0,15539005,0,15539005,0,0,15536810,2195,15539005
2022-06-15,492,497,492,494,44337,0.0,0,0,2,-2,0,0,0,10052,0,10052,0,0,10050,2,10052,0,0,4365,-4365,0,0,0,21965250,0,21965250,0,0,21960885,4365,21965250
2022-06-16,496,496,494,494,34668,0.0,0,0,1,-1,0,0,0,7860,0,7860,0,0,7859,1,7860,0,0,2190,-2190,0,0,0,17135120,0,17135120,0,0,17132930,2190,17135120
2022-06-17,496,496,491,493,139302,-0.20242914979757085,0,0,13220,-13220,0,0,0,31582,0,31582,0,0,18362,13220,31582,0,0,28687400,-28687400,0,0,0,68599795,0,68599795,0,0,39912395,28687400,68599795
2022-06-20,493,494,491,493,133025,0.0,0,0,0,0,0,0,0,30159,0,30159,0,0,30159,0,30159,0,0,0,0,0,0,0,65555735,0,65555735,0,0,65555735,0,65555735
2022-06-21,493,493,490,493,110883,0.0,0,0,0,0,0,0,0,25139,0,25139,0,0,25139,0,25139,0,0,0,0,0,0,0,54527575,0,54527575,0,0,54527575,0,54527575
2022-06-22,494,494,493,493,41179,0.0,0,0,0,0,0,0,0,9336,0,9336,0,0,9336,0,9336,0,0,0,0,0,0,0,20306565,0,20306565,0,0,20306565,0,20306565
2022-06-23,493,493,491,493,102216,0.0,0,0,0,0,0,0,0,23174,0,23174,0,0,23174,0,23174,0,0,0,0,0,0,0,50299540,0,50299540,0,0,50299540,0,50299540
2022-06-24,492,494,491,494,102039,0.2028397565922921,0,0,0,0,0,0,0,23134,0,23134,0,0,23134,0,23134,0,0,0,0,0,0,0,50267775,0,50267775,0,0,50267775,0,50267775
2022-06-27,493,496,493,495,64375,0.20242914979757085,0,0,0,0,0,0,0,14595,0,14595,0,0,14595,0,14595,0,0,0,0,0,0,0,31862975,0,31862975,0,0,31862975,0,31862975
2022-06-28,497,497,493,495,317375,0.0,0,0,0,0,0,0,0,71954,0,71954,0,0,71954,0,71954,0,0,0,0,0,0,0,157034990,0,157034990,0,0,157034990,0,157034990
2022-06-29,489,489,484,486,73457,-1.8181818181818181,0,3,-3,0,0,0,3,16651,0,16654,0,0,16654,0,16654,0,6430,-6430,0,0,0,6430,35701680,0,35708110,0,0,35708110,0,35708110
2022-06-30,486,486,482,484,28758,-0.411522633744856,0,2,-2,0,0,0,2,6518,0,6520,0,0,6520,0,6520,0,4265,-4265,0,0,0,4265,13886065,0,13890330,0,0,13890330,0,13890330
2022-07-01,483,483,481,481,132306,-0.6198347107438017,0,0,1,-1,0,0,0,29996,0,29996,0,0,29995,1,29996,0,0,2130,-2130,0,0,0,63890625,0,63890625,0,0,63888495,2130,63890625
2022-07-04,482,483,480,482,89058,0.2079002079002079,0,0,0,0,0,0,0,20191,0,20191,0,0,20191,0,20191,0,0,0,0,0,0,0,43080380,0,43080380,0,0,43080380,0,43080380
2022-07-05,482,485,482,484,133828,0.4149377593360996,0,0,0,0,0,0,0,30341,0,30341,0,0,30341,0,30341,0,0,0,0,0,0,0,64753040,0,64753040,0,0,64753040,0,64753040
2022-07-06,485,485,484,484,332429,0.0,0,0,0,0,0,0,0,75367,0,75367,0,0,75367,0,75367,0,0,0,0,0,0,0,161121955,0,161121955,0,0,161121955,0,161121955
2022-07-07,482,483,482,482,111730,-0.4132231404958678,-50,1,49,0,0,0,1,25330,0,25331,50,0,25281,0,25331,-106750,2130,104620,0,0,0,2130,53953150,0,53955280,106750,0,53848530,0,53955280
2022-07-08,485,485,482,484,190291,0.4149377593360996,1687,0,-1687,0,0,1687,0,41455,0,43142,0,0,43142,0,43142,3610180,0,-3610180,0,0,3610180,0,88339665,0,91949845,0,0,91949845,0,91949845
2022-07-11,486,486,482,484,111324,0.0,0,0,0,0,0,0,0,25239,0,25239,0,0,25239,0,25239,0,0,0,0,0,0,0,53916830,0,53916830,0,0,53916830,0,53916830
2022-07-12,483,483,480,482,135614,-0.4132231404958678,0,0,0,0,0,0,0,30746,0,30746,0,0,30746,0,30746,0,0,0,0,0,0,0,65568485,0,65568485,0,0,65568485,0,65568485
2022-07-13,482,483,480,482,96512,0.0,0,0,0,0,0,0,0,21881,0,21881,0,0,21881,0,21881,0,0,0,0,0,0,0,46602895,0,46602895,0,0,46602895,0,46602895
2022-07-14,482,485,482,485,48179,0.6224066390041494,0,0,0,0,0,0,0,10923,0,10923,0,0,10923,0,10923,0,0,0,0,0,0,0,23269230,0,23269230,0,0,23269230,0,23269230
2022-07-15,484,490,484,490,440145,1.0309278350515463,-40000,0,39703,297,0,0,0,99491,297,99788,40000,0,59788,0,99788,-86200000,0,85558480,641520,0,0,0,214474775,641520,215116295,86200000,0,128916295,0,215116295
2022-07-18,502,502,490,496,229260,1.2244897959183674,-39882,0,39882,0,0,118,0,51859,0,51977,40000,0,11977,0,51977,-87074585,0,87074585,0,0,255470,0,113267630,0,113523100,87330055,0,26193045,0,113523100
2022-07-19,501,503,501,503,457118,1.411290322580645,-20000,0,20000,0,0,0,0,103636,0,103636,20000,0,83636,0,103636,-44350000,0,44350000,0,0,0,0,229688045,0,229688045,44350000,0,185338045,0,229688045
2022-07-20,505,506,502,502,85287,-0.19880715705765406,-1000,0,1000,0,0,0,0,19336,0,19336,1000,0,18336,0,19336,-2235000,0,2235000,0,0,0,0,43050755,0,43050755,2235000,0,40815755,0,43050755
2022-07-21,503,503,502,502,34536,0.0,0,0,0,0,0,0,0,7830,0,7830,0,0,7830,0,7830,0,0,0,0,0,0,0,17343505,0,17343505,0,0,17343505,0,17343505
2022-07-22,498,503,498,503,23646,0.199203187250996,0,1,6,-7,0,0,1,5360,0,5361,0,0,5354,7,5361,0,2210,13295,-15505,0,0,2210,11870965,0,11873175,0,0,11857670,15505,11873175
2022-07-25,499,502,499,502,13964,-0.19880715705765406,0,0,0,0,0,0,0,3166,0,3166,0,0,3166,0,3166,0,0,0,0,0,0,0,6987625,0,6987625,0,0,6987625,0,6987625
2022-07-26,500,503,500,502,135244,0.0,-20580,0,20580,0,0,0,0,30662,0,30662,20580,0,10082,0,30662,-45584725,0,45584725,0,0,0,0,67941765,0,67941765,45584725,0,22357040,0,67941765
2022-07-27,499,501,499,501,44553,-0.199203187250996,0,0,0,0,0,0,0,10101,0,10101,0,0,10101,0,10101,0,0,0,0,0,0,0,22297710,0,22297710,0,0,22297710,0,22297710
2022-07-28,501,501,501,501,31850,0.0,0,0,0,0,0,0,0,7221,0,7221,0,0,7221,0,7221,0,0,0,0,0,0,0,15958410,0,15958410,0,0,15958410,0,15958410
2022-07-29,500,502,498,498,133440,-0.5988023952095809,-23000,0,23001,-1,0,0,0,30253,0,30253,23000,0,7252,1,30253,-50725010,0,50727225,-2215,0,0,0,66707645,0,66707645,50725010,0,15980420,2215,66707645
2022-08-01,497,501,497,499,15120,0.2008032128514056,-2900,0,2900,0,0,0,0,3428,0,3428,2900,0,528,0,3428,-6396650,0,6396650,0,0,0,0,7558650,0,7558650,6396650,0,1162000,0,7558650
2022-08-02,498,498,496,496,208309,-0.6012024048096193,-46000,2,45998,0,0,0,2,47225,0,47227,46000,0,1227,0,47227,-100765000,4380,100760620,0,0,0,4380,103448800,0,103453180,100765000,0,2688180,0,103453180
2022-08-03,496,496,494,496,113869,0.0,-25000,0,25000,0,0,0,0,25816,0,25816,25000,0,816,0,25816,-54750000,0,54750000,0,0,0,0,56535045,0,56535045,54750000,0,1785045,0,56535045
2022-08-04,494,497,494,496,32459,0.0,-3201,0,3201,0,0,0,0,7359,0,7359,3201,0,4158,0,7359,-7010195,0,7010195,0,0,0,0,16095425,0,16095425,7010195,0,9085230,0,16095425
2022-08-05,501,501,494,494,63118,-0.4032258064516129,-12307,0,12307,0,0,0,0,14310,0,14310,12307,0,2003,0,14310,-26902355,0,26902355,0,0,0,0,31268990,0,31268990,26902355,0,4366635,0,31268990
2022-08-08,495,496,493,493,82883,-0.20242914979757085,-17017,0,17017,0,0,0,0,18791,0,18791,17017,0,1774,0,18791,-37060490,0,37060490,0,0,0,0,40940050,0,40940050,37060490,0,3879560,0,40940050
2022-08-09,490,497,490,494,263625,0.2028397565922921,-55001,0,55001,0,0,0,0,59768,0,59768,55001,0,4767,0,59768,-119627195,0,119627195,0,0,0,0,130016755,0,130016755,119627195,0,10389560,0,130016755
2022-08-10,494,496,494,494,206875,0.0,-3704,0,3704,0,0,0,0,46902,0,46902,3704,0,43198,0,46902,-8105630,0,8105630,0,0,0,0,102341105,0,102341105,8105630,0,94235475,0,102341105
2022-08-11,493,496,493,496,59497,0.4048582995951417,-8000,0,8000,0,0,0,0,13489,0,13489,8000,0,5489,0,13489,-17520000,0,17520000,0,0,0,0,29540900,0,29540900,17520000,0,12020900,0,29540900
2022-08-12,496,496,496,496,74044,0.0,0,0,0,0,0,0,0,16787,0,16787,0,0,16787,0,16787,0,0,0,0,0,0,0,36763530,0,36763530,0,0,36763530,0,36763530
2022-08-16,497,497,494,496,65354,0.0,0,0,0,0,0,0,0,14817,0,14817,0,0,14817,0,14817,0,0,0,0,0,0,0,32479950,0,32479950,0,0,32479950,0,32479950
2022-08-17,496,497,496,496,34863,0.0,0,0,0,0,0,0,0,7904,0,7904,0,0,7904,0,7904,0,0,0,0,0,0,0,17309905,0,17309905,0,0,17309905,0,17309905
2022-08-18,495,497,494,497,53794,0.20161290322580644,0,0,0,0,0,0,0,12196,0,12196,0,0,12196,0,12196,0,0,0,0,0,0,0,26708805,0,26708805,0,0,26708805,0,26708805
2022-08-19,497,502,497,502,104200,1.0060362173038229,0,0,0,0,0,0,0,23624,0,23624,0,0,23624,0,23624,0,0,0,0,0,0,0,52182800,0,52182800,0,0,52182800,0,52182800
2022-08-22,503,506,503,503,238713,0.199203187250996,0,0,0,0,0,0,0,54120,0,54120,0,0,54120,0,54120,0,0,0,0,0,0,0,120540020,0,120540020,0,0,120540020,0,120540020
2022-08-23,502,506,502,505,128420,0.3976143141153081,-15000,0,15000,0,0,0,0,29115,0,29115,15000,0,14115,0,29115,-33450000,0,33450000,0,0,0,0,64925705,0,64925705,33450000,0,31475705,0,64925705
2022-08-24,506,506,503,503,17660,-0.39603960396039606,0,0,0,0,0,0,0,4004,0,4004,0,0,4004,0,4004,0,0,0,0,0,0,0,8889645,0,8889645,0,0,8889645,0,8889645
2022-08-25,497,502,497,502,98074,-0.19880715705765406,-20000,1,19999,0,0,0,1,22234,0,22235,20000,0,2235,0,22235,-43900000,2210,43897790,0,0,0,2210,48844140,0,48846350,43900000,0,4946350,0,48846350
2022-08-26,501,503,501,503,51752,0.199203187250996,-5000,0,5000,0,0,0,0,11733,0,11733,5000,0,6733,0,11733,-11075000,0,11075000,0,0,0,0,25993650,0,25993650,11075000,0,14918650,0,25993650
2022-08-29,500,505,500,505,106150,0.3976143141153081,-20000,0,20000,0,0,0,0,24066,0,24066,20000,0,4066,0,24066,-44500000,0,44500000,0,0,0,0,53549805,0,53549805,44500000,0,9049805,0,53549805
2022-08-30,503,505,502,505,68552,0.0,0,0,0,0,0,0,0,15542,0,15542,0,0,15542,0,15542,0,0,0,0,0,0,0,34524385,0,34524385,0,0,34524385,0,34524385
2022-08-31,505,505,502,505,116873,0.0,-20002,1,20001,0,0,0,1,26496,0,26497,20002,0,6495,0,26497,-44404450,2220,44402230,0,0,0,2220,58821240,0,58823460,44404450,0,14419010,0,58823460
2022-09-01,505,506,503,505,329006,0.0,-30000,0,30000,0,0,0,0,74591,0,74591,30000,0,44591,0,74591,-67000000,0,67000000,0,0,0,0,166590360,0,166590360,67000000,0,99590360,0,166590360
2022-09-02,506,507,504,506,333739,0.19801980198019803,-30000,0,30000,0,0,0,0,75664,0,75664,30000,0,45664,0,75664,-67100000,0,67100000,0,0,0,0,169207130,0,169207130,67100000,0,102107130,0,169207130
2022-09-05,505,508,505,507,169886,0.1976284584980237,-15173,0,15173,0,0,0,0,38516,0,38516,15173,0,23343,0,38516,-33987520,0,33987520,0,0,0,0,86299190,0,86299190,33987520,0,52311670,0,86299190
2022-09-06,507,508,505,507,89014,0.0,0,1,257,-258,0,0,1,20180,0,20181,0,0,19923,258,20181,0,2235,576975,-579210,0,0,2235,45221705,0,45223940,0,0,44644730,579210,45223940
2022-09-07,508,511,508,511,369714,0.7889546351084813,-20000,0,22320,-2320,0,0,0,83820,0,83820,20000,0,61500,2320,83820,-45100000,0,50331600,-5231600,0,0,0,188729540,0,188729540,45100000,0,138397940,5231600,188729540
2022-09-08,510,513,510,512,309175,0.19569471624266144,-28735,0,28734,1,0,0,0,70094,1,70095,28735,0,41360,0,70095,-64891100,0,64888835,2265,0,0,0,158505120,2265,158507385,64891100,0,93616285,0,158507385
2022-09-13,512,512,510,510,153306,-0.390625,-20000,0,20001,-1,0,0,0,34757,0,34757,20000,0,14756,1,34757,-45000000,0,45002250,-2250,0,0,0,78244190,0,78244190,45000000,0,33241940,2250,78244190
2022-09-14,512,514,510,510,37897,0.0,-2778,0,2778,0,0,0,0,8592,0,8592,2778,0,5814,0,8592,-6306060,0,6306060,0,0,0,0,19464940,0,19464940,6306060,0,13158880,0,19464940
2022-09-15,509,513,509,513,112396,0.5882352941176471,-10000,0,10000,0,0,0,0,25482,0,25482,10000,0,15482,0,25482,-22550090,0,22550090,0,0,0,0,57465070,0,57465070,22550090,0,34914980,0,57465070
2022-09-16,512,512,509,511,325376,-0.3898635477582846,-6997,2,6995,0,0,0,2,73766,0,73768,6997,0,66771,0,73768,-15778235,4515,15773720,0,0,0,4515,166663580,0,166668095,15778235,0,150889860,0,166668095
2022-09-19,509,512,509,512,118125,0.19569471624266144,-20000,0,20000,0,0,0,0,26781,0,26781,20000,0,6781,0,26781,-45100000,0,45100000,0,0,0,0,60384785,0,60384785,45100000,0,15284785,0,60384785
2022-09-20,512,512,511,511,8049,-0.1953125,0,0,0,0,0,0,0,1825,0,1825,0,0,1825,0,1825,0,0,0,0,0,0,0,4124495,0,4124495,0,0,4124495,0,4124495
2022-09-21,511,512,511,511,145270,0.0,-28927,0,28925,2,0,0,0,32933,2,32935,28927,0,4008,0,32935,-65230385,0,65225870,4515,0,0,0,74263915,4515,74268430,65230385,0,9038045,0,74268430
2022-09-22,512,512,511,511,189678,0.0,-4599,0,4599,0,0,0,0,43003,0,43003,4599,0,38404,0,43003,-10370745,0,10370745,0,0,0,0,97138275,0,97138275,10370745,0,86767530,0,97138275
2022-09-23,546,546,526,528,949281,3.326810176125244,0,0,0,0,0,0,0,215217,0,215217,0,0,215217,0,215217,0,0,0,0,0,0,0,507332015,0,507332015,0,0,507332015,0,507332015
2022-09-26,528,531,528,531,649041,0.5681818181818182,-75000,0,75015,-15,0,0,0,147148,0,147148,75000,0,72133,15,147148,-175150000,0,175185100,-35100,0,0,0,343719210,0,343719210,175150000,0,168534110,35100,343719210
2022-09-27,526,533,526,530,661436,-0.18832391713747645,-12868,0,12826,42,0,0,0,149916,42,149958,12868,0,137090,0,149958,-30129140,0,30030440,98700,0,0,0,351847530,98700,351946230,30129140,0,321817090,0,351946230
2022-09-28,532,535,531,535,260820,0.9433962264150944,-6007,0,6007,0,0,0,0,59132,0,59132,6007,0,53125,0,59132,-14161520,0,14161520,0,0,0,0,139002895,0,139002895,14161520,0,124841375,0,139002895
2022-09-29,464,471,464,468,288722,-12.52336448598131,0,0,0,0,0,0,0,65458,0,65458,0,0,65458,0,65458,0,0,0,0,0,0,0,135293985,0,135293985,0,0,135293985,0,135293985
2022-09-30,466,471,466,471,251155,0.641025641025641,0,0,0,0,0,0,0,56941,0,56941,0,0,56941,0,56941,0,0,0,0,0,0,0,117834500,0,117834500,0,0,117834500,0,117834500
2022-10-04,471,474,471,474,233565,0.6369426751592357,-10000,0,9991,9,0,0,0,52944,9,52953,10000,0,42953,0,52953,-20950000,0,20931180,18820,0,0,0,110751425,18820,110770245,20950000,0,89820245,0,110770245
2022-10-05,472,475,472,472,277263,-0.42194092827004215,-44405,0,44447,-42,0,0,0,62860,0,62860,44405,0,18413,42,62860,-92716685,0,92804465,-87780,0,0,0,131310105,0,131310105,92716685,0,38505640,87780,131310105
2022-10-06,472,472,469,471,209063,-0.211864406779661,0,0,0,0,0,0,0,47398,0,47398,0,0,47398,0,47398,0,0,0,0,0,0,0,98504520,0,98504520,0,0,98504520,0,98504520
2022-10-07,472,472,467,471,63145,0.0,0,-1000,1000,0,0,0,0,14316,0,14316,0,1000,13316,0,14316,0,-2075000,2075000,0,0,0,0,29736690,0,29736690,0,2075000,27661690,0,29736690
2022-10-11,471,471,470,470,124592,-0.21231422505307856,0,0,0,0,0,0,0,28247,0,28247,0,0,28247,0,28247,0,0,0,0,0,0,0,58701815,0,58701815,0,0,58701815,0,58701815
2022-10-12,472,472,469,469,159477,-0.2127659574468085,-22176,0,22176,0,0,0,0,36156,0,36156,22176,0,13980,0,36156,-45979320,0,45979320,0,0,0,0,75062720,0,75062720,45979320,0,29083400,0,75062720
2022-10-13,472,472,470,472,81308,0.6396588486140725,0,0,0,0,0,0,0,18434,0,18434,0,0,18434,0,18434,0,0,0,0,0,0,0,38361220,0,38361220,0,0,38361220,0,38361220
2022-10-14,471,474,471,474,239873,0.423728813559322,-15000,0,15000,0,0,0,0,54383,0,54383,15000,0,39383,0,54383,-31275000,0,31275000,0,0,0,0,113443260,0,113443260,31275000,0,82168260,0,113443260
2022-10-17,472,475,472,474,324759,0.0,-65000,0,65000,0,0,0,0,73628,0,73628,65000,0,8628,0,73628,-135950000,0,135950000,0,0,0,0,154040955,0,154040955,135950000,0,18090955,0,154040955
2022-10-18,471,473,470,473,487473,-0.21097046413502107,-92851,2,92691,158,0,0,2,110358,158,110518,92851,0,17667,0,110518,-193333590,4170,192999990,329430,0,0,4170,229890550,329430,230224150,193333590,0,36890560,0,230224150
2022-10-19,473,476,473,476,107822,0.6342494714587738,-3000,0,3000,0,0,0,0,24445,0,24445,3000,0,21445,0,24445,-6300000,0,6300000,0,0,0,0,51263070,0,51263070,6300000,0,44963070,0,51263070
2022-10-20,474,479,474,477,342420,0.21008403361344538,-35000,0,35000,0,0,0,0,77632,0,77632,35000,0,42632,0,77632,-73585000,0,73585000,0,0,0,0,163180655,0,163180655,73585000,0,89595655,0,163180655
2022-10-21,479,479,477,479,65046,0.41928721174004197,-2025,0,2025,0,0,0,0,14747,0,14747,2025,0,12722,0,14747,-4282875,0,4282875,0,0,0,0,31164760,0,31164760,4282875,0,26881885,0,31164760
2022-10-24,478,482,478,482,133828,0.6263048016701461,-6000,0,6000,0,0,0,0,30341,0,30341,6000,0,24341,0,30341,-12765000,0,12765000,0,0,0,0,64482920,0,64482920,12765000,0,51717920,0,64482920
2022-10-25,481,484,481,484,39291,0.4149377593360996,0,0,0,0,0,0,0,8908,0,8908,0,0,8908,0,8908,0,0,0,0,0,0,0,18999970,0,18999970,0,0,18999970,0,18999970
2022-10-26,483,485,483,485,49484,0.2066115702479339,-717,0,717,0,0,0,0,11219,0,11219,717,0,10502,0,11219,-1534380,0,1534380,0,0,0,0,24003650,0,24003650,1534380,0,22469270,0,24003650
2022-10-27,486,486,484,486,89583,0.2061855670103093,0,0,-127,127,0,0,0,20183,127,20310,0,0,20310,0,20310,0,0,-272415,272415,0,0,0,43254035,272415,43526450,0,0,43526450,0,43526450
2022-10-28,486,489,485,489,258195,0.6172839506172839,0,0,0,0,0,0,0,58537,0,58537,0,0,58537,0,58537,0,0,0,0,0,0,0,126059345,0,126059345,0,0,126059345,0,126059345
2022-10-31,489,489,487,489,50561,0.0,0,1,-1,0,0,0,1,11462,0,11463,0,0,11463,0,11463,0,2155,-2155,0,0,0,2155,24742420,0,24744575,0,0,24744575,0,24744575
2022-11-01,489,491,489,491,172978,0.408997955010225,0,0,1,-1,0,0,0,39217,0,39217,0,0,39216,1,39217,0,0,2165,-2165,0,0,0,85027695,0,85027695,0,0,85025530,2165,85027695
2022-11-02,477,494,477,493,456615,0.40733197556008144,0,0,0,0,0,0,0,103522,0,103522,0,0,103522,0,103522,0,0,0,0,0,0,0,224341430,0,224341430,0,0,224341430,0,224341430
2022-11-03,494,495,493,493,245792,0.0,-19148,0,19148,0,0,0,0,55725,0,55725,19148,0,36577,0,55725,-41668570,0,41668570,0,0,0,0,121429925,0,121429925,41668570,0,79761355,0,121429925
2022-11-04,492,495,492,495,457127,0.4056795131845842,-50000,0,50000,0,0,0,0,103638,0,103638,50000,0,53638,0,103638,-109150000,0,109150000,0,0,0,0,225963090,0,225963090,109150000,0,116813090,0,225963090
2022-11-07,493,495,493,493,386854,-0.40404040404040403,-31878,0,31878,0,0,0,0,87706,0,87706,31878,0,55828,0,87706,-69418190,0,69418190,0,0,0,0,191011450,0,191011450,69418190,0,121593260,0,191011450
2022-11-08,492,493,482,486,164408,-1.4198782961460445,-10000,0,10000,0,0,0,0,37274,0,37274,10000,0,27274,0,37274,-21450000,0,21450000,0,0,0,0,80144255,0,80144255,21450000,0,58694255,0,80144255
2022-11-09,483,483,477,482,192059,-0.823045267489712,-3902,2,3801,99,0,0,2,43442,99,43543,3902,0,39641,0,43543,-8330770,4255,8117130,209385,0,0,4255,92267030,209385,92480670,8330770,0,84149900,0,92480670
2022-11-10,479,483,479,482,122704,0.0,-10000,0,10000,0,0,0,0,27819,0,27819,10000,0,17819,0,27819,-21300000,0,21300000,0,0,0,0,59285170,0,59285170,21300000,0,37985170,0,59285170
2022-11-11,482,482,467,467,360160,-3.112033195020747,-16896,3,16893,0,0,0,3,81651,0,81654,16896,0,64758,0,81654,-35078160,6310,35071850,0,0,0,6310,170577475,0,170583785,35078160,0,135505625,0,170583785
2022-11-14,463,465,461,465,130604,-0.4282655246252677,-8192,2,8190,0,0,0,2,29608,0,29610,8192,0,21418,0,29610,-16711680,4100,16707580,0,0,0,4100,60568640,0,60572740,16711680,0,43861060,0,60572740
2022-11-15,465,465,463,463,137339,-0.43010752688172044,-30000,0,29775,225,0,0,0,30912,225,31137,30000,0,1137,0,31137,-61425000,0,60963750,461250,0,0,0,63308700,461250,63769950,61425000,0,2344950,0,63769950
2022-11-16,461,464,461,463,237500,0.0,0,0,0,0,0,0,0,53845,0,53845,0,0,53845,0,53845,0,0,0,0,0,0,0,110117015,0,110117015,0,0,110117015,0,110117015
2022-11-17,467,467,461,464,82499,0.21598272138228944,0,0,0,0,0,0,0,18704,0,18704,0,0,18704,0,18704,0,0,0,0,0,0,0,38159385,0,38159385,0,0,38159385,0,38159385
2022-11-18,466,466,462,464,65121,0.0,0,0,0,0,0,0,0,14764,0,14764,0,0,14764,0,14764,0,0,0,0,0,0,0,30216200,0,30216200,0,0,30216200,0,30216200
2022-11-21,465,467,465,467,62642,0.646551724137931,0,0,0,0,0,0,0,14202,0,14202,0,0,14202,0,14202,0,0,0,0,0,0,0,29218110,0,29218110,0,0,29218110,0,29218110
2022-11-22,468,469,465,467,299286,0.0,-44443,0,44443,0,0,0,0,67853,0,67853,44443,0,23410,0,67853,-91513490,0,91513490,0,0,0,0,139754275,0,139754275,91513490,0,48240785,0,139754275
2022-11-23,468,468,466,468,6051,0.21413276231263384,0,0,0,0,0,0,0,1372,0,1372,0,0,1372,0,1372,0,0,0,0,0,0,0,2827885,0,2827885,0,0,2827885,0,2827885
2022-11-24,466,466,461,463,159958,-1.0683760683760684,-30000,3,29999,-2,0,0,3,36262,0,36265,30000,0,6263,2,36265,-61210085,6120,61208085,-4120,0,0,6120,74030515,0,74036635,61210085,0,12822430,4120,74036635
2022-11-25,463,463,459,462,587180,-0.21598272138228944,-65000,0,65000,0,0,0,0,133123,0,133123,65000,0,68123,0,133123,-132400000,0,132400000,0,0,0,0,270849310,0,270849310,132400000,0,138449310,0,270849310
2022-11-28,464,464,461,464,73581,0.4329004329004329,-15000,0,15000,0,0,0,0,16682,0,16682,15000,0,1682,0,16682,-30600000,0,30600000,0,0,0,0,34048090,0,34048090,30600000,0,3448090,0,34048090
2022-11-29,464,464,464,464,9090,0.0,0,0,-61,61,0,0,0,2000,61,2061,0,0,2061,0,2061,0,0,-125050,125050,0,0,0,4100000,125050,4225050,0,0,4225050,0,4225050
2022-11-30,464,464,462,462,148684,-0.43103448275862066,-25000,0,25145,-145,0,0,0,33709,0,33709,25000,0,8564,145,33709,-51000000,0,51295800,-295800,0,0,0,68852000,0,68852000,51000000,0,17556200,295800,68852000
2022-12-01,463,463,459,462,206117,0.0,-10000,1,9999,0,0,0,1,46729,0,46730,10000,0,36730,0,46730,-20300000,2030,20297970,0,0,0,2030,94927970,0,94930000,20300000,0,74630000,0,94930000
2022-12-02,461,462,458,460,183445,-0.4329004329004329,-29940,2,29938,0,0,0,2,41588,0,41590,29940,0,11650,0,41590,-60828200,4055,60824145,0,0,0,4055,84449435,0,84453490,60828200,0,23625290,0,84453490
2022-12-05,483,483,460,462,163014,0.43478260869565216,-10000,0,10000,0,0,0,0,36958,0,36958,10000,0,26958,0,36958,-20400000,0,20400000,0,0,0,0,75459785,0,75459785,20400000,0,55059785,0,75459785
2022-12-06,462,468,462,467,47279,1.0822510822510822,-4713,0,4713,0,0,0,0,10719,0,10719,4713,0,6006,0,10719,-9708780,0,9708780,0,0,0,0,22076250,0,22076250,9708780,0,12367470,0,22076250
2022-12-07,469,469,467,467,96724,0.0,-4210,0,4210,0,0,0,0,21929,0,21929,4210,0,17719,0,21929,-8691150,0,8691150,0,0,0,0,45281410,0,45281410,8691150,0,36590260,0,45281410
2022-12-08,463,468,463,468,167694,0.21413276231263384,-37000,0,37000,0,0,0,0,38019,0,38019,37000,0,1019,0,38019,-75807595,0,75807595,0,0,0,0,77896480,0,77896480,75807595,0,2088885,0,77896480
2022-12-09,463,465,463,463,124230,-1.0683760683760684,-14664,1,14663,0,0,0,1,28164,0,28165,14664,0,13501,0,28165,-29987880,2050,29985830,0,0,0,2050,57598690,0,57600740,29987880,0,27612860,0,57600740
2022-12-12,465,465,463,463,215609,0.0,-35000,0,35000,0,0,0,0,48882,0,48882,35000,0,13882,0,48882,-71575000,0,71575000,0,0,0,0,99963770,0,99963770,71575000,0,28388770,0,99963770
2022-12-13,464,464,461,464,203113,0.21598272138228944,0,0,0,0,0,0,0,46049,0,46049,0,0,46049,0,46049,0,0,0,0,0,0,0,94142790,0,94142790,0,0,94142790,0,94142790
2022-12-14,462,464,462,464,487540,0.0,0,0,0,0,0,0,0,110533,0,110533,0,0,110533,0,110533,0,0,0,0,0,0,0,226295150,0,226295150,0,0,226295150,0,226295150
2022-12-15,464,464,462,464,320268,0.0,0,0,0,0,0,0,0,72610,0,72610,0,0,72610,0,72610,0,0,0,0,0,0,0,148839000,0,148839000,0,0,148839000,0,148839000
2022-12-16,470,470,465,467,14061,0.646551724137931,0,0,0,0,0,0,0,3188,0,3188,0,0,3188,0,3188,0,0,0,0,0,0,0,6610580,0,6610580,0,0,6610580,0,6610580
2022-12-19,467,467,465,467,280051,0.0,0,0,0,0,0,0,0,63492,0,63492,0,0,63492,0,63492,0,0,0,0,0,0,0,130777860,0,130777860,0,0,130777860,0,130777860
2022-12-20,465,467,465,465,269447,-0.4282655246252677,-28743,0,28743,0,0,0,0,61088,0,61088,28743,0,32345,0,61088,-59066865,0,59066865,0,0,0,0,125547405,0,125547405,59066865,0,66480540,0,125547405
2022-12-21,465,465,464,464,255972,-0.21505376344086022,-18102,0,18102,0,0,0,0,58033,0,58033,18102,0,39931,0,58033,-37109100,0,37109100,0,0,0,0,118991065,0,118991065,37109100,0,81881965,0,118991065
2022-12-22,472,472,461,463,295736,-0.21551724137931033,-65849,0,66005,-156,0,0,0,67048,0,67048,65849,0,1043,156,67048,-134379985,0,134698615,-318630,0,0,0,136847235,0,136847235,134379985,0,2148620,318630,136847235
2022-12-23,465,465,460,460,633224,-0.6479481641468683,-6049,0,6049,0,0,5164,0,138398,0,143562,11213,0,132349,0,143562,-12309695,0,12309695,0,0,10508760,0,281961995,0,292470755,22818455,0,269652300,0,292470755
2022-12-26,463,463,459,462,402711,0.43478260869565216,-26605,0,26605,0,0,0,0,91301,0,91301,26605,0,64696,0,91301,-54274200,0,54274200,0,0,0,0,186237875,0,186237875,54274200,0,131963675,0,186237875
2022-12-27,461,463,461,463,165603,0.21645021645021645,0,0,0,0,0,0,0,37545,0,37545,0,0,37545,0,37545,0,0,0,0,0,0,0,76639755,0,76639755,0,0,76639755,0,76639755
2022-12-28,470,470,463,463,13924,0.0,0,0,0,0,0,0,0,3157,0,3157,0,0,3157,0,3157,0,0,0,0,0,0,0,6484560,0,6484560,0,0,6484560,0,6484560
2022-12-29,470,470,465,465,107160,0.4319654427645789,0,0,0,0,0,0,0,24295,0,24295,0,0,24295,0,24295,0,0,0,0,0,0,0,50315655,0,50315655,0,0,50315655,0,50315655
2023-01-02,470,470,465,467,62496,0.43010752688172044,0,0,0,0,0,0,0,14169,0,14169,0,0,14169,0,14169,0,0,0,0,0,0,0,29147410,0,29147410,0,0,29147410,0,29147410
2023-01-03,469,469,467,469,279742,0.4282655246252677,-13092,0,13092,0,0,0,0,63422,0,63422,13092,0,50330,0,63422,-27100440,0,27100440,0,0,0,0,131209000,0,131209000,27100440,0,104108560,0,131209000
2023-01-04,468,470,467,470,179422,0.21321961620469082,0,0,0,0,0,0,0,40678,0,40678,0,0,40678,0,40678,0,0,0,0,0,0,0,84300085,0,84300085,0,0,84300085,0,84300085
2023-01-05,469,471,468,471,618453,0.2127659574468085,-70000,0,70000,0,0,0,0,140213,0,140213,70000,0,70213,0,140213,-145105640,0,145105640,0,0,0,0,290753165,0,290753165,145105640,0,145647525,0,290753165
2023-01-06,471,471,469,469,123383,-0.42462845010615713,-3085,0,3085,0,0,0,0,27973,0,27973,3085,0,24888,0,27973,-6401375,0,6401375,0,0,0,0,57995760,0,57995760,6401375,0,51594385,0,57995760
2023-01-09,468,468,463,463,253506,-1.279317697228145,-6408,3,6405,0,0,0,3,57471,0,57474,6408,0,51066,0,57474,-13205480,6145,13199335,0,0,0,6145,117658090,0,117664235,13205480,0,104458755,0,117664235
2023-01-10,462,464,461,464,211727,0.21598272138228944,-10197,0,10197,0,0,0,0,48002,0,48002,10197,0,37805,0,48002,-20806905,0,20806905,0,0,0,0,98018015,0,98018015,20806905,0,77211110,0,98018015
2023-01-11,462,466,462,462,302100,-0.43103448275862066,-62000,0,62000,0,0,0,0,68491,0,68491,62000,0,6491,0,68491,-126480000,0,126480000,0,0,0,0,139752745,0,139752745,126480000,0,13272745,0,139752745
2023-01-12,461,464,461,463,1032103,0.21645021645021645,0,0,0,0,0,0,0,233994,0,233994,0,0,233994,0,233994,0,0,0,0,0,0,0,478768505,0,478768505,0,0,478768505,0,478768505
2023-01-13,461,463,461,461,359891,-0.4319654427645789,-50000,-8813,58813,0,0,0,0,81593,0,81593,50000,8813,22780,0,81593,-101750000,-17934455,119684455,0,0,0,0,166048755,0,166048755,101750000,17934455,46364300,0,166048755
2023-01-16,459,459,455,455,1577283,-1.3015184381778742,-77911,2,77909,0,0,0,2,357593,0,357595,77911,0,279684,0,357595,-156740665,4040,156736625,0,0,0,4040,722063910,0,722067950,156740665,0,565327285,0,722067950
2023-01-17,462,462,456,459,36583,0.8791208791208791,0,0,-10,10,0,0,0,8284,10,8294,0,0,8294,0,8294,0,0,-20250,20250,0,0,0,16741620,20250,16761870,0,0,16761870,0,16761870
2023-01-18,455,456,455,455,1095473,-0.8714596949891068,-47068,0,47068,0,0,0,0,248361,0,248361,47068,0,201293,0,248361,-94606680,0,94606680,0,0,0,0,499210610,0,499210610,94606680,0,404603930,0,499210610
2023-01-19,455,455,452,454,340166,-0.21978021978021978,-50000,0,50000,0,0,0,0,77121,0,77121,50000,0,27121,0,77121,-100000000,0,100000000,0,0,0,0,154246560,0,154246560,100000000,0,54246560,0,154246560
2023-01-20,466,466,454,454,83920,0.0,0,0,0,0,0,0,0,19026,0,19026,0,0,19026,0,19026,0,0,0,0,0,0,0,38271810,0,38271810,0,0,38271810,0,38271810
2023-01-25,458,458,451,453,240997,-0.22026431718061676,0,0,0,0,0,0,0,54638,0,54638,0,0,54638,0,54638,0,0,0,0,0,0,0,109126445,0,109126445,0,0,109126445,0,109126445
2023-01-26,457,457,451,453,392279,0.0,-55000,0,55000,0,0,0,0,88936,0,88936,55000,0,33936,0,88936,-109975000,0,109975000,0,0,0,0,177808395,0,177808395,109975000,0,67833395,0,177808395
2023-01-27,452,452,450,450,723866,-0.6622516556291391,-68000,0,68000,0,0,12000,0,152112,0,164112,80000,0,84112,0,164112,-135319211,0,135319211,0,0,23880789,0,302879952,0,326760741,159200000,0,167560741,0,326760741
2023-01-30,450,450,449,449,283359,-0.2222222222222222,26,0,-26,0,0,26,0,64216,0,64242,0,0,64242,0,64242,51558,0,-51558,0,0,51558,0,127399484,0,127451042,0,0,127451042,0,127451042
2023-01-31,453,453,448,449,417240,0.0,0,0,0,0,0,0,0,94595,0,94595,0,0,94595,0,94595,0,0,0,0,0,0,0,187500495,0,187500495,0,0,187500495,0,187500495
2023-02-01,452,452,448,448,358823,-0.22271714922048996,0,0,0,0,0,0,0,81351,0,81351,0,0,81351,0,81351,0,0,0,0,0,0,0,161130391,0,161130391,0,0,161130391,0,161130391
2023-02-02,448,448,444,445,164474,-0.6696428571428571,20,0,-173,153,0,20,0,37116,153,37289,0,0,37289,0,37289,39400,0,-340198,300798,0,39400,0,73141010,300798,73481208,0,0,73481208,0,73481208
2023-02-03,444,446,444,446,555034,0.22471910112359553,-47000,0,47000,0,0,3000,0,122835,0,125835,50000,0,75835,0,125835,-92334047,0,92334047,0,0,5892000,0,241284339,0,247176339,98226047,0,148950292,0,247176339
2023-02-06,451,451,446,447,360208,0.2242152466367713,-10148,0,10148,0,0,0,0,81665,0,81665,10148,0,71517,0,81665,-20092179,0,20092179,0,0,0,0,161563919,0,161563919,20092179,0,141471740,0,161563919
2023-02-07,452,452,447,448,336434,0.22371364653243847,1000,-13254,12724,-470,0,1000,0,75275,0,76275,0,13254,62551,470,76275,1980000,-26242920,25193520,-930600,0,1980000,0,149044622,0,151024622,0,26242920,123851102,930600,151024622
2023-02-08,452,452,446,450,99904,0.4464285714285714,34,1000,-1034,0,0,34,1000,21616,0,22650,0,0,22650,0,22650,67524,1981000,-2048524,0,0,67524,1981000,42948479,0,44997003,0,0,44997003,0,44997003
2023-02-09,450,452,449,451,215340,0.2222222222222222,7,18147,-18154,0,0,7,18147,30667,0,48821,0,0,48821,0,48821,13895,36110412,-36124307,0,0,13895,36110412,60994826,0,97119133,0,0,97119133,0,97119133
2023-02-10,452,453,450,453,153452,0.4434589800443459,0,0,153,-153,0,0,0,34790,0,34790,0,0,34637,153,34790,0,0,306000,-306000,0,0,0,69375516,0,69375516,0,0,69069516,306000,69375516
2023-02-13,457,457,453,453,486093,0.0,0,0,0,0,0,0,0,110205,0,110205,0,0,110205,0,110205,0,0,0,0,0,0,0,220451870,0,220451870,0,0,220451870,0,220451870
2023-02-14,457,457,453,453,186639,0.0,-15000,-18147,33147,0,0,2000,0,40314,0,42314,17000,18147,7167,0,42314,-30000000,-36294000,66294000,0,0,4000000,0,80640590,0,84640590,34000000,36294000,14346590,0,84640590
2023-02-15,452,455,452,454,189223,0.22075055187637968,1000,0,-1000,0,0,1000,0,41900,0,42900,0,0,42900,0,42900,2000000,0,-2000000,0,0,2000000,0,83800040,0,85800040,0,0,85800040,0,85800040
2023-02-16,455,455,453,453,199897,-0.22026431718061676,-14000,-1000,15000,0,0,1000,0,44320,0,45320,15000,1000,29320,0,45320,-28000000,-2005000,30005000,0,0,2000000,0,88655260,0,90655260,30000000,2005000,58650260,0,90655260
2023-02-17,454,457,453,457,264044,0.8830022075055187,0,0,3976,-3976,0,0,0,59863,0,59863,0,0,55887,3976,59863,0,0,7971880,-7971880,0,0,0,120603820,0,120603820,0,0,112631940,7971880,120603820
2023-02-20,457,458,455,455,39154,-0.437636761487965,0,0,0,0,0,0,0,8877,0,8877,0,0,8877,0,8877,0,0,0,0,0,0,0,17916535,0,17916535,0,0,17916535,0,17916535
2023-02-21,454,457,454,457,65840,0.43956043956043955,7000,0,-7000,0,0,7000,0,7927,0,14927,0,0,14927,0,14927,14105000,0,-14105000,0,0,14105000,0,15975155,0,30080155,0,0,30080155,0,30080155
2023-02-22,457,457,454,457,175439,0.0,0,0,0,0,0,0,0,39775,0,39775,0,0,39775,0,39775,0,0,0,0,0,0,0,80002650,0,80002650,0,0,80002650,0,80002650
2023-02-23,455,458,455,457,60595,0.0,-7527,0,7527,0,0,0,0,13738,0,13738,7527,0,6211,0,13738,-15204540,0,15204540,0,0,0,0,27744310,0,27744310,15204540,0,12539770,0,27744310
2023-02-24,457,460,457,457,227747,0.0,25021,0,-25021,0,0,25021,0,26613,0,51634,0,0,51634,0,51634,50542420,0,-50542420,0,0,50542420,0,53854445,0,104396865,0,0,104396865,0,104396865
2023-02-27,464,465,462,464,80016,1.5317286652078774,1114,0,-1104,-10,0,3615,0,14526,0,18141,2501,0,15630,10,18141,2284700,0,-2264200,-20500,0,7410750,0,29806470,0,37217220,5126050,0,32070670,20500,37217220
2023-02-28,464,469,464,469,20977,1.0775862068965518,0,0,0,0,0,0,0,4756,0,4756,0,0,4756,0,4756,0,0,0,0,0,0,0,9790830,0,9790830,0,0,9790830,0,9790830
2023-03-02,469,469,466,469,448561,0.0,87435,0,-87435,0,0,87435,0,14261,0,101696,0,0,101696,0,101696,180989360,0,-180989360,0,0,180989360,0,29520240,0,210509600,0,0,210509600,0,210509600
2023-03-03,471,471,465,467,287950,-0.42643923240938164,49366,0,-49366,0,0,49366,0,15917,0,65283,0,0,65283,0,65283,101897220,0,-101897220,0,0,101897220,0,32903950,0,134801170,0,0,134801170,0,134801170
2023-03-06,463,466,463,465,428417,-0.4282655246252677,34737,0,-34737,0,0,34737,0,62392,0,97129,0,0,97129,0,97129,71384535,0,-71384535,0,0,71384535,0,128201760,0,199586295,0,0,199586295,0,199586295
2023-03-07,465,468,465,467,483177,0.43010752688172044,31825,0,-31825,0,0,91668,0,17876,0,109544,59843,0,49701,0,109544,65559500,0,-65559500,0,0,188836080,0,36744475,0,225580555,123276580,0,102303975,0,225580555
2023-03-08,466,471,466,470,210514,0.6423982869379015,-9029,0,9229,-200,0,29391,0,18336,0,47727,38420,0,9107,200,47727,-18735705,0,19147705,-412000,0,60692415,0,38073865,0,98766280,79428120,0,18926160,412000,98766280
2023-03-09,471,471,469,469,257198,-0.2127659574468085,-41815,0,41815,0,0,8185,0,50126,0,58311,50000,0,8311,0,58311,-86657050,0,86657050,0,0,16942950,0,103897475,0,120840425,103600000,0,17240425,0,120840425
2023-03-10,470,470,467,469,135063,0.0,-527,0,527,0,0,0,0,30621,0,30621,527,0,30094,0,30621,-1090890,0,1090890,0,0,0,0,63375030,0,63375030,1090890,0,62284140,0,63375030
2023-03-13,468,469,467,467,618351,-0.42643923240938164,7471,0,-7471,0,0,68161,0,72029,0,140190,60690,0,79500,0,140190,15498575,0,-15498575,0,0,140673425,0,148690620,0,289364045,125174850,0,164189195,0,289364045
2023-03-14,467,469,466,469,8852,0.4282655246252677,0,0,0,0,0,0,0,2007,0,2007,0,0,2007,0,2007,0,0,0,0,0,0,0,4135670,0,4135670,0,0,4135670,0,4135670
2023-03-15,466,469,466,468,360301,-0.21321961620469082,-30436,0,30436,0,0,29564,0,52122,0,81686,60000,0,21686,0,81686,-62698160,0,62698160,0,0,60901840,0,107449645,0,168351485,123600000,0,44751485,0,168351485
2023-03-16,472,472,466,471,205226,0.641025641025641,-10253,0,10253,0,0,29747,0,16781,0,46528,40000,0,6528,0,46528,-21121180,0,21121180,0,0,61278820,0,34580090,0,95858910,82400000,0,13458910,0,95858910
2023-03-17,469,469,468,468,186365,-0.6369426751592357,-23305,0,23305,0,0,0,0,42252,0,42252,23305,0,18947,0,42252,-48141350,0,48141350,0,0,0,0,87291035,0,87291035,48141350,0,39149685,0,87291035
2023-03-20,472,472,466,470,28277,0.4273504273504274,5379,0,-5379,0,0,5379,0,1032,0,6411,0,0,6411,0,6411,11080740,0,-11080740,0,0,11080740,0,2126315,0,13207055,0,0,13207055,0,13207055
2023-03-21,471,471,466,468,59678,-0.425531914893617,0,0,0,0,0,0,0,13530,0,13530,0,0,13530,0,13530,0,0,0,0,0,0,0,27935980,0,27935980,0,0,27935980,0,27935980
2023-03-22,471,473,467,471,24113,0.641025641025641,0,0,0,0,0,0,0,5467,0,5467,0,0,5467,0,5467,0,0,0,0,0,0,0,11297910,0,11297910,0,0,11297910,0,11297910
2023-03-23,470,470,465,465,186537,-1.2738853503184715,0,0,0,0,0,0,0,42291,0,42291,0,0,42291,0,42291,0,0,0,0,0,0,0,87101325,0,87101325,0,0,87101325,0,87101325
2023-03-24,469,469,467,467,118465,0.43010752688172044,-17748,0,17748,0,0,0,0,26858,0,26858,17748,0,9110,0,26858,-36560880,0,36560880,0,0,0,0,55362580,0,55362580,36560880,0,18801700,0,55362580
2023-03-27,471,471,467,467,115616,0.0,-10000,0,10000,0,0,0,0,26212,0,26212,10000,0,16212,0,26212,-20600000,0,20600000,0,0,0,0,54069195,0,54069195,20600000,0,33469195,0,54069195
2023-03-28,467,471,467,467,79840,0.0,-10000,0,10000,0,0,0,0,18101,0,18101,10000,0,8101,0,18101,-20600000,0,20600000,0,0,0,0,37289060,0,37289060,20600000,0,16689060,0,37289060
2023-03-29,471,471,464,467,250432,0.0,-30000,0,30000,0,0,0,0,56777,0,56777,30000,0,26777,0,56777,-61500000,0,61500000,0,0,0,0,116551085,0,116551085,61500000,0,55051085,0,116551085
2023-03-30,466,470,466,469,8583,0.4282655246252677,0,0,0,0,0,0,0,1946,0,1946,0,0,1946,0,1946,0,0,0,0,0,0,0,4011740,0,4011740,0,0,4011740,0,4011740
2023-03-31,467,467,464,464,1703022,-1.0660980810234542,21419,0,-21419,0,0,346527,0,39575,0,386102,325108,0,60994,0,386102,43857870,0,-43857870,0,0,710380350,0,81180070,0,791560420,666522480,0,125037940,0,791560420
2023-04-03,471,471,467,467,688942,0.646551724137931,-36994,0,36994,0,0,117963,0,38231,0,156194,154957,0,1237,0,156194,-76207640,0,76207640,0,0,243003780,0,78767900,0,321771680,319211420,0,2560260,0,321771680
2023-04-04,469,469,465,469,201172,0.4282655246252677,37781,0,-37781,0,0,37781,0,7828,0,45609,0,0,45609,0,45609,77639970,0,-77639970,0,0,77639970,0,16121040,0,93761010,0,0,93761010,0,93761010
2023-04-05,466,471,466,470,76862,0.21321961620469082,0,0,0,0,0,0,0,17426,0,17426,0,0,17426,0,17426,0,0,0,0,0,0,0,35904465,0,35904465,0,0,35904465,0,35904465
2023-04-06,471,471,468,470,18992,0.0,0,0,0,0,0,0,0,4306,0,4306,0,0,4306,0,4306,0,0,0,0,0,0,0,8918810,0,8918810,0,0,8918810,0,8918810
2023-04-07,471,471,467,469,181998,-0.2127659574468085,0,0,0,0,0,0,0,41262,0,41262,0,0,41262,0,41262,0,0,0,0,0,0,0,85411170,0,85411170,0,0,85411170,0,85411170
2023-04-10,471,471,468,471,182559,0.42643923240938164,0,0,0,0,0,0,0,41389,0,41389,0,0,41389,0,41389,0,0,0,0,0,0,0,85764600,0,85764600,0,0,85764600,0,85764600
2023-04-11,472,472,469,472,322456,0.21231422505307856,-5056,0,5056,0,0,0,0,73106,0,73106,5056,0,68050,0,73106,-10514825,0,10514825,0,0,0,0,152068875,0,152068875,10514825,0,141554050,0,152068875
2023-04-12,468,475,468,473,312483,0.211864406779661,0,0,0,0,0,0,0,70845,0,70845,0,0,70845,0,70845,0,0,0,0,0,0,0,148118070,0,148118070,0,0,148118070,0,148118070
2023-04-13,473,478,473,476,4159,0.6342494714587738,0,0,0,0,0,0,0,943,0,943,0,0,943,0,943,0,0,0,0,0,0,0,1980200,0,1980200,0,0,1980200,0,1980200
2023-04-14,475,475,473,473,119696,-0.6302521008403361,0,0,0,0,0,0,0,27137,0,27137,0,0,27137,0,27137,0,0,0,0,0,0,0,56795435,0,56795435,0,0,56795435,0,56795435
2023-04-17,479,479,471,474,1036,0.21141649048625794,0,0,0,0,0,0,0,235,0,235,0,0,235,0,235,0,0,0,0,0,0,0,493890,0,493890,0,0,493890,0,493890
2023-04-18,474,479,474,476,269769,0.42194092827004215,0,0,5611,-5611,0,0,0,61161,0,61161,0,0,55550,5611,61161,0,0,11755045,-11755045,0,0,0,128413855,0,128413855,0,0,116658810,11755045,128413855
2023-04-19,480,480,472,474,100685,-0.42016806722689076,0,0,0,0,0,0,0,22827,0,22827,0,0,22827,0,22827,0,0,0,0,0,0,0,47715715,0,47715715,0,0,47715715,0,47715715
2023-04-20,475,479,475,477,71755,0.6329113924050633,0,0,0,0,0,0,0,16268,0,16268,0,0,16268,0,16268,0,0,0,0,0,0,0,34318750,0,34318750,0,0,34318750,0,34318750
2023-04-21,480,480,475,478,79795,0.20964360587002098,0,0,0,0,0,0,0,18091,0,18091,0,0,18091,0,18091,0,0,0,0,0,0,0,38016535,0,38016535,0,0,38016535,0,38016535
2023-04-24,482,482,475,479,63502,0.20920502092050208,0,0,0,0,0,0,0,14397,0,14397,0,0,14397,0,14397,0,0,0,0,0,0,0,30437600,0,30437600,0,0,30437600,0,30437600
2023-04-25,481,481,476,479,30500,0.0,0,0,0,0,0,0,0,6915,0,6915,0,0,6915,0,6915,0,0,0,0,0,0,0,14622285,0,14622285,0,0,14622285,0,14622285
2023-04-26,478,483,478,481,133294,0.41753653444676403,6609,0,-6609,0,0,6609,0,23611,0,30220,0,0,30220,0,30220,13978035,0,-13978035,0,0,13978035,0,50225990,0,64204025,0,0,64204025,0,64204025
2023-04-27,485,486,483,485,206439,0.8316008316008316,30604,0,-30604,0,0,30604,0,16199,0,46803,0,0,46803,0,46803,65341075,0,-65341075,0,0,65341075,0,34636100,0,99977175,0,0,99977175,0,99977175
2023-04-28,485,485,481,484,49383,-0.2061855670103093,500,0,-500,0,0,500,0,10696,0,11196,0,0,11196,0,11196,1070000,0,-1070000,0,0,1070000,0,22866890,0,23936890,0,0,23936890,0,23936890
2023-05-02,486,486,485,485,56956,0.2066115702479339,0,0,0,0,0,0,0,12913,0,12913,0,0,12913,0,12913,0,0,0,0,0,0,0,27651355,0,27651355,0,0,27651355,0,27651355
2023-05-03,485,485,483,485,8270,0.0,0,0,0,0,0,0,0,1875,0,1875,0,0,1875,0,1875,0,0,0,0,0,0,0,4007500,0,4007500,0,0,4007500,0,4007500
2023-05-04,485,487,484,484,94506,-0.2061855670103093,0,0,0,0,0,0,0,21426,0,21426,0,0,21426,0,21426,0,0,0,0,0,0,0,45851745,0,45851745,0,0,45851745,0,45851745
2023-05-08,487,487,485,487,49612,0.6198347107438017,0,0,0,0,0,0,0,11248,0,11248,0,0,11248,0,11248,0,0,0,0,0,0,0,24177190,0,24177190,0,0,24177190,0,24177190
2023-05-09,487,487,486,486,88674,-0.20533880903490762,1,0,3313,-3314,0,1,0,20103,0,20104,0,0,16790,3314,20104,2145,0,7106385,-7108530,0,2145,0,43121045,0,43123190,0,0,36014660,7108530,43123190
2023-05-10,487,487,483,486,77621,0.0,23,0,-23,0,0,23,0,17575,0,17598,0,0,17598,0,17598,49105,0,-49105,0,0,49105,0,37632390,0,37681495,0,0,37681495,0,37681495
2023-05-11,484,487,484,486,18481,0.0,0,0,0,0,0,0,0,4190,0,4190,0,0,4190,0,4190,0,0,0,0,0,0,0,8987115,0,8987115,0,0,8987115,0,8987115
2023-05-12,487,487,484,487,8168,0.205761316872428,0,0,0,0,0,0,0,1852,0,1852,0,0,1852,0,1852,0,0,0,0,0,0,0,3972160,0,3972160,0,0,3972160,0,3972160
2023-05-15,489,489,484,487,18432,0.0,0,0,0,0,0,0,0,4179,0,4179,0,0,4179,0,4179,0,0,0,0,0,0,0,8985960,0,8985960,0,0,8985960,0,8985960
2023-05-16,487,487,482,487,29080,0.0,1500,0,-1500,0,0,1500,0,5093,0,6593,0,0,6593,0,6593,3225000,0,-3225000,0,0,3225000,0,10880830,0,14105830,0,0,14105830,0,14105830
2023-05-17,489,489,487,487,40129,0.0,0,0,0,0,0,0,0,9098,0,9098,0,0,9098,0,9098,0,0,0,0,0,0,0,19563355,0,19563355,0,0,19563355,0,19563355
2023-05-18,489,489,487,489,32198,0.41067761806981523,0,0,0,0,0,0,0,7300,0,7300,0,0,7300,0,7300,0,0,0,0,0,0,0,15760000,0,15760000,0,0,15760000,0,15760000
2023-05-19,491,491,488,490,36053,0.2044989775051125,-3000,0,3000,0,0,0,0,8174,0,8174,3000,0,5174,0,8174,-6495000,0,6495000,0,0,0,0,17682965,0,17682965,6495000,0,11187965,0,17682965
2023-05-22,490,491,488,490,81110,0.0,-5000,0,5000,0,0,0,0,18389,0,18389,5000,0,13389,0,18389,-10850000,0,10850000,0,0,0,0,39853955,0,39853955,10850000,0,29003955,0,39853955
2023-05-23,490,490,488,488,73634,-0.40816326530612246,0,0,0,0,0,0,0,16694,0,16694,0,0,16694,0,16694,0,0,0,0,0,0,0,36043470,0,36043470,0,0,36043470,0,36043470
2023-05-24,492,492,488,488,85432,0.0,0,0,0,0,0,0,0,19369,0,19369,0,0,19369,0,19369,0,0,0,0,0,0,0,41743340,0,41743340,0,0,41743340,0,41743340
2023-05-25,488,491,488,490,143964,0.4098360655737705,5595,0,-5595,0,0,16395,0,16244,0,32639,10800,0,21839,0,32639,12109175,0,-12109175,0,0,35495175,0,35124645,0,70619820,23386000,0,47233820,0,70619820
2023-05-26,492,492,489,491,45197,0.20408163265306123,-9821,0,9821,0,0,0,0,10247,0,10247,9821,0,426,0,10247,-21286570,0,21286570,0,0,0,0,22213120,0,22213120,21286570,0,926550,0,22213120
2023-05-30,491,491,489,491,36490,0.0,-5000,0,5000,0,0,0,0,8273,0,8273,5000,0,3273,0,8273,-10850000,0,10850000,0,0,0,0,17951885,0,17951885,10850000,0,7101885,0,17951885
2023-05-31,493,493,491,491,28776,0.0,-5400,0,5400,0,0,0,0,6524,0,6524,5400,0,1124,0,6524,-11718000,0,11718000,0,0,0,0,14163585,0,14163585,11718000,0,2445585,0,14163585
2023-06-01,494,494,491,494,5509,0.6109979633401221,0,0,0,0,0,0,0,1249,0,1249,0,0,1249,0,1249,0,0,0,0,0,0,0,2716560,0,2716560,0,0,2716560,0,2716560
2023-06-02,494,494,493,493,75645,-0.20242914979757085,0,0,0,0,0,0,0,17150,0,17150,0,0,17150,0,17150,0,0,0,0,0,0,0,37301450,0,37301450,0,0,37301450,0,37301450
2023-06-05,492,492,491,491,84078,-0.4056795131845842,0,0,0,0,0,0,0,19062,0,19062,0,0,19062,0,19062,0,0,0,0,0,0,0,41384320,0,41384320,0,0,41384320,0,41384320
2023-06-07,493,493,491,491,18856,0.0,0,0,0,0,0,0,0,4275,0,4275,0,0,4275,0,4275,0,0,0,0,0,0,0,9277150,0,9277150,0,0,9277150,0,9277150
2023-06-08,493,493,490,490,15243,-0.20366598778004072,0,0,0,0,0,0,0,3456,0,3456,0,0,3456,0,3456,0,0,0,0,0,0,0,7493490,0,7493490,0,0,7493490,0,7493490
2023-06-09,492,492,489,489,64693,-0.20408163265306123,0,0,0,0,0,0,0,14667,0,14667,0,0,14667,0,14667,0,0,0,0,0,0,0,31728255,0,31728255,0,0,31728255,0,31728255
2023-06-12,486,489,485,489,82596,0.0,0,1,-1,0,0,0,1,18725,0,18726,0,0,18726,0,18726,0,2150,-2150,0,0,0,2150,40173265,0,40175415,0,0,40175415,0,40175415
2023-06-13,487,487,484,486,235352,-0.6134969325153374,0,0,0,0,0,0,0,53358,0,53358,0,0,53358,0,53358,0,0,0,0,0,0,0,114407780,0,114407780,0,0,114407780,0,114407780
2023-06-14,489,489,482,486,50993,0.0,0,0,0,0,0,0,0,11561,0,11561,0,0,11561,0,11561,0,0,0,0,0,0,0,24694080,0,24694080,0,0,24694080,0,24694080
2023-06-15,486,488,486,486,133700,0.0,0,0,0,0,0,0,0,30312,0,30312,0,0,30312,0,30312,0,0,0,0,0,0,0,65022260,0,65022260,0,0,65022260,0,65022260
2023-06-16,482,486,482,486,80404,0.0,0,0,0,0,0,0,0,18229,0,18229,0,0,18229,0,18229,0,0,0,0,0,0,0,39038065,0,39038065,0,0,39038065,0,39038065
2023-06-19,485,487,485,487,58235,0.205761316872428,0,0,0,0,0,0,0,13203,0,13203,0,0,13203,0,13203,0,0,0,0,0,0,0,28328940,0,28328940,0,0,28328940,0,28328940
2023-06-20,486,487,484,486,68292,-0.20533880903490762,0,0,0,0,0,0,0,15483,0,15483,0,0,15483,0,15483,0,0,0,0,0,0,0,33179440,0,33179440,0,0,33179440,0,33179440
2023-06-21,492,492,484,486,134419,0.0,0,0,0,0,0,0,0,30475,0,30475,0,0,30475,0,30475,0,0,0,0,0,0,0,65244250,0,65244250,0,0,65244250,0,65244250
2023-06-22,489,489,484,488,258627,0.411522633744856,50050,0,-50050,0,0,50050,0,8585,0,58635,0,0,58635,0,58635,107357250,0,-107357250,0,0,107357250,0,18420545,0,125777795,0,0,125777795,0,125777795
2023-06-23,492,492,488,488,306538,0.0,0,0,500,-500,0,0,0,69497,0,69497,0,0,68997,500,69497,0,0,1080000,-1080000,0,0,0,150032575,0,150032575,0,0,148952575,1080000,150032575
2023-06-26,492,492,487,489,38193,0.20491803278688525,0,0,0,0,0,0,0,8659,0,8659,0,0,8659,0,8659,0,0,0,0,0,0,0,18691980,0,18691980,0,0,18691980,0,18691980
2023-06-27,494,495,493,493,187605,0.81799591002045,0,0,0,0,0,0,0,42533,0,42533,0,0,42533,0,42533,0,0,0,0,0,0,0,92704920,0,92704920,0,0,92704920,0,92704920
2023-06-28,496,496,492,496,45863,0.6085192697768762,0,0,0,0,0,0,0,10398,0,10398,0,0,10398,0,10398,0,0,0,0,0,0,0,22750185,0,22750185,0,0,22750185,0,22750185
2023-06-29,497,497,493,497,473491,0.20161290322580644,0,0,0,0,0,0,0,107348,0,107348,0,0,107348,0,107348,0,0,0,0,0,0,0,234619380,0,234619380,0,0,234619380,0,234619380
2023-06-30,495,498,495,498,32163,0.2012072434607646,0,0,0,0,0,0,0,7292,0,7292,0,0,7292,0,7292,0,0,0,0,0,0,0,15995695,0,15995695,0,0,15995695,0,15995695
2023-07-03,498,499,496,496,15543,-0.4016064257028112,0,0,0,0,0,0,0,3524,0,3524,0,0,3524,0,3524,0,0,0,0,0,0,0,7752010,0,7752010,0,0,7752010,0,7752010
2023-07-04,497,497,495,497,134123,0.20161290322580644,0,0,0,0,0,0,0,30408,0,30408,0,0,30408,0,30408,0,0,0,0,0,0,0,66645345,0,66645345,0,0,66645345,0,66645345
2023-07-05,498,498,494,498,54376,0.2012072434607646,0,0,0,0,0,0,0,12328,0,12328,0,0,12328,0,12328,0,0,0,0,0,0,0,27043850,0,27043850,0,0,27043850,0,27043850
2023-07-06,492,497,492,497,264057,-0.2008032128514056,0,0,0,0,0,0,0,59866,0,59866,0,0,59866,0,59866,0,0,0,0,0,0,0,131387270,0,131387270,0,0,131387270,0,131387270
2023-07-07,498,498,493,495,383899,-0.4024144869215292,45107,0,-45107,0,0,45107,0,41929,0,87036,0,0,87036,0,87036,98558795,0,-98558795,0,0,98558795,0,91600080,0,190158875,0,0,190158875,0,190158875
2023-07-10,497,497,493,495,28039,0.0,0,0,0,0,0,0,0,6357,0,6357,0,0,6357,0,6357,0,0,0,0,0,0,0,13890175,0,13890175,0,0,13890175,0,13890175
2023-07-11,493,496,493,495,3131,0.0,0,0,0,0,0,0,0,710,0,710,0,0,710,0,710,0,0,0,0,0,0,0,1551325,0,1551325,0,0,1551325,0,1551325
2023-07-12,495,496,493,495,257613,0.0,34368,0,-34368,0,0,34368,0,24037,0,58405,0,0,58405,0,58405,75094080,0,-75094080,0,0,75094080,0,52552720,0,127646800,0,0,127646800,0,127646800
2023-07-13,496,496,493,496,42039,0.20202020202020202,0,0,0,0,0,0,0,9531,0,9531,0,0,9531,0,9531,0,0,0,0,0,0,0,20848670,0,20848670,0,0,20848670,0,20848670
2023-07-14,497,497,493,493,351228,-0.6048387096774194,0,0,0,0,0,0,0,79629,0,79629,0,0,79629,0,79629,0,0,0,0,0,0,0,174130030,0,174130030,0,0,174130030,0,174130030
2023-07-17,493,496,493,493,35260,0.0,0,0,500,-500,0,0,0,7994,0,7994,0,0,7494,500,7994,0,0,1090000,-1090000,0,0,0,17423400,0,17423400,0,0,16333400,1090000,17423400
2023-07-18,491,493,490,490,57411,-0.6085192697768762,0,-10000,10000,0,0,0,0,13016,0,13016,0,10000,3016,0,13016,0,-21700000,21700000,0,0,0,0,28244355,0,28244355,0,21700000,6544355,0,28244355
2023-07-19,497,497,491,491,32331,0.20408163265306123,0,-5190,5190,0,0,0,0,7330,0,7330,0,5190,2140,0,7330,0,-11269800,11269800,0,0,0,0,15922035,0,15922035,0,11269800,4652235,0,15922035
2023-07-20,491,495,485,491,133488,0.0,-60,0,60,0,0,0,0,30264,0,30264,60,0,30204,0,30264,-130440,0,130440,0,0,0,0,64979555,0,64979555,130440,0,64849115,0,64979555
2023-07-21,495,495,487,490,102595,-0.20366598778004072,0,-5000,5000,0,0,0,0,23260,0,23260,0,5000,18260,0,23260,0,-10825000,10825000,0,0,0,0,50287755,0,50287755,0,10825000,39462755,0,50287755
2023-07-24,496,496,491,495,66175,1.0204081632653061,0,-13700,13700,0,0,0,0,15003,0,15003,0,13700,1303,0,15003,0,-29744000,29744000,0,0,0,0,32592560,0,32592560,0,29744000,2848560,0,32592560
2023-07-25,494,499,492,496,82764,0.20202020202020202,0,0,0,0,0,0,0,18764,0,18764,0,0,18764,0,18764,0,0,0,0,0,0,0,41204115,0,41204115,0,0,41204115,0,41204115
2023-07-26,495,497,494,497,112400,0.20161290322580644,45,0,-45,0,0,45,0,25438,0,25483,0,0,25483,0,25483,98550,0,-98550,0,0,98550,0,55807395,0,55905945,0,0,55905945,0,55905945
2023-07-27,448,448,442,446,131936,-10.261569416498995,0,0,0,0,0,0,0,29912,0,29912,0,0,29912,0,29912,0,0,0,0,0,0,0,58668679,0,58668679,0,0,58668679,0,58668679
2023-07-28,448,448,442,446,189589,0.0,0,0,0,0,0,0,0,42983,0,42983,0,0,42983,0,42983,0,0,0,0,0,0,0,84857816,0,84857816,0,0,84857816,0,84857816
2023-07-31,446,446,442,443,41814,-0.672645739910314,0,0,0,0,0,0,0,9480,0,9480,0,0,9480,0,9480,0,0,0,0,0,0,0,18544506,0,18544506,0,0,18544506,0,18544506
2023-08-01,445,445,442,443,42136,0.0,0,0,0,0,0,0,0,9553,0,9553,0,0,9553,0,9553,0,0,0,0,0,0,0,18711268,0,18711268,0,0,18711268,0,18711268
2023-08-02,447,447,442,445,117817,0.4514672686230248,0,0,0,0,0,0,0,26711,0,26711,0,0,26711,0,26711,0,0,0,0,0,0,0,52400040,0,52400040,0,0,52400040,0,52400040
2023-08-03,447,447,445,447,208485,0.44943820224719105,14141,0,-14141,0,0,14141,0,33126,0,47267,0,0,47267,0,47267,27886052,0,-27886052,0,0,27886052,0,65318280,0,93204332,0,0,93204332,0,93204332
2023-08-04,448,452,447,452,51505,1.1185682326621924,0,0,0,0,0,0,0,11677,0,11677,0,0,11677,0,11677,0,0,0,0,0,0,0,23151319,0,23151319,0,0,23151319,0,23151319
2023-08-07,448,449,448,449,200696,-0.6637168141592921,0,0,0,0,0,0,0,45501,0,45501,0,0,45501,0,45501,0,0,0,0,0,0,0,90136342,0,90136342,0,0,90136342,0,90136342
2023-08-08,450,450,449,450,124446,0.22271714922048996,0,0,0,0,0,0,0,28214,0,28214,0,0,28214,0,28214,0,0,0,0,0,0,0,55964496,0,55964496,0,0,55964496,0,55964496
2023-08-09,450,451,448,451,151506,0.2222222222222222,0,0,0,0,0,0,0,34349,0,34349,0,0,34349,0,34349,0,0,0,0,0,0,0,68365027,0,68365027,0,0,68365027,0,68365027
2023-08-10,451,452,451,452,35634,0.22172949002217296,2881,0,-2881,0,0,2881,0,5198,0,8079,0,0,8079,0,8079,5741833,0,-5741833,0,0,5741833,0,10365676,0,16107509,0,0,16107509,0,16107509
2023-08-11,452,453,451,453,140197,0.22123893805309736,0,0,0,0,0,0,0,31785,0,31785,0,0,31785,0,31785,0,0,0,0,0,0,0,63551947,0,63551947,0,0,63551947,0,63551947
2023-08-14,453,456,453,456,352511,0.6622516556291391,2000,0,-2000,0,0,2000,0,77920,0,79920,0,0,79920,0,79920,4020000,0,-4020000,0,0,4020000,0,156471775,0,160491775,0,0,160491775,0,160491775
2023-08-16,457,460,457,459,268887,0.6578947368421052,0,0,-10,10,0,0,0,60951,10,60961,0,0,60961,0,60961,0,0,-20250,20250,0,0,0,123351875,20250,123372125,0,0,123372125,0,123372125
2023-08-17,458,461,458,460,219124,0.2178649237472767,0,0,0,0,0,0,0,49679,0,49679,0,0,49679,0,49679,0,0,0,0,0,0,0,100870970,0,100870970,0,0,100870970,0,100870970
2023-08-18,457,462,457,462,266602,0.43478260869565216,0,0,0,0,0,0,0,60443,0,60443,0,0,60443,0,60443,0,0,0,0,0,0,0,123159310,0,123159310,0,0,123159310,0,123159310
2023-08-21,461,464,461,463,253617,0.21645021645021645,0,0,0,0,0,0,0,57499,0,57499,0,0,57499,0,57499,0,0,0,0,0,0,0,117619530,0,117619530,0,0,117619530,0,117619530
2023-08-22,461,463,461,463,154620,0.0,0,0,0,0,0,0,0,35055,0,35055,0,0,35055,0,35055,0,0,0,0,0,0,0,71519555,0,71519555,0,0,71519555,0,71519555
2023-08-23,461,463,461,463,115876,0.0,0,0,0,0,0,0,0,26271,0,26271,0,0,26271,0,26271,0,0,0,0,0,0,0,53721695,0,53721695,0,0,53721695,0,53721695
2023-08-24,463,463,462,462,566630,-0.21598272138228944,0,0,0,0,0,0,0,128464,0,128464,0,0,128464,0,128464,0,0,0,0,0,0,0,262296835,0,262296835,0,0,262296835,0,262296835
2023-08-25,463,463,460,462,4066,0.0,0,0,0,0,0,0,0,922,0,922,0,0,922,0,922,0,0,0,0,0,0,0,1877175,0,1877175,0,0,1877175,0,1877175
2023-08-28,458,462,458,460,133091,-0.4329004329004329,-4983,0,4983,0,0,0,0,30174,0,30174,4983,0,25191,0,30174,-10121710,0,10121710,0,0,0,0,61460875,0,61460875,10121710,0,51339165,0,61460875
2023-08-29,462,462,461,461,36261,0.21739130434782608,0,0,0,0,0,0,0,8221,0,8221,0,0,8221,0,8221,0,0,0,0,0,0,0,16729890,0,16729890,0,0,16729890,0,16729890
2023-08-30,455,461,455,461,24356,0.0,-4931,0,4931,0,0,0,0,5522,0,5522,4931,0,591,0,5522,-9956510,0,9956510,0,0,0,0,11159180,0,11159180,9956510,0,1202670,0,11159180
2023-08-31,459,462,459,462,28851,0.21691973969631237,0,0,0,0,0,0,0,6541,0,6541,0,0,6541,0,6541,0,0,0,0,0,0,0,13282420,0,13282420,0,0,13282420,0,13282420
2023-09-01,462,462,455,461,83950,-0.21645021645021645,-8011,0,8011,0,0,0,0,19033,0,19033,8011,0,11022,0,19033,-16235620,0,16235620,0,0,0,0,38406055,0,38406055,16235620,0,22170435,0,38406055
2023-09-04,460,460,457,460,52210,-0.21691973969631237,-9770,0,9770,0,0,0,0,11837,0,11837,9770,0,2067,0,11837,-19816810,0,19816810,0,0,0,0,24012820,0,24012820,19816810,0,4196010,0,24012820
2023-09-05,462,462,457,462,82393,0.43478260869565216,0,0,0,0,0,0,0,18680,0,18680,0,0,18680,0,18680,0,0,0,0,0,0,0,37926750,0,37926750,0,0,37926750,0,37926750
2023-09-06,460,461,457,460,267153,-0.4329004329004329,-11456,0,7395,4061,0,0,0,56507,4061,60568,11456,0,49112,0,60568,-23227040,0,14983210,8243830,0,0,0,114527570,8243830,122771400,23227040,0,99544360,0,122771400
2023-09-07,463,463,459,461,135098,0.21739130434782608,0,0,-3771,3771,0,0,0,26858,3771,30629,0,0,30629,0,30629,0,0,-7655130,7655130,0,0,0,54569430,7655130,62224560,0,0,62224560,0,62224560
2023-09-08,460,462,459,462,245227,0.21691973969631237,0,0,-3073,3073,0,0,0,52524,3073,55597,0,0,55597,0,55597,0,0,-6238190,6238190,0,0,0,106643595,6238190,112881785,0,0,112881785,0,112881785
2023-09-11,464,464,460,460,70621,-0.4329004329004329,0,0,-4196,4196,0,0,0,11815,4196,16011,0,0,16011,0,16011,0,0,-8517880,8517880,0,0,0,24020805,8517880,32538685,0,0,32538685,0,32538685
2023-09-12,460,460,459,459,137665,-0.21739130434782608,-2937,0,2937,0,0,0,0,31211,0,31211,2937,0,28274,0,31211,-5953545,0,5953545,0,0,0,0,63326260,0,63326260,5953545,0,57372715,0,63326260
2023-09-13,462,462,458,460,47006,0.2178649237472767,0,0,0,0,0,0,0,10657,0,10657,0,0,10657,0,10657,0,0,0,0,0,0,0,21583790,0,21583790,0,0,21583790,0,21583790
2023-09-14,462,462,460,460,95202,0.0,0,0,-3272,3272,0,0,0,18312,3272,21584,0,0,21584,0,21584,0,0,-6642160,6642160,0,0,0,37197285,6642160,43839445,0,0,43839445,0,43839445
2023-09-15,462,462,460,460,230407,0.0,0,0,0,0,0,0,0,52237,0,52237,0,0,52237,0,52237,0,0,0,0,0,0,0,106070025,0,106070025,0,0,106070025,0,106070025
2023-09-18,464,464,460,460,316978,0.0,0,0,0,0,0,0,0,71864,0,71864,0,0,71864,0,71864,0,0,0,0,0,0,0,145883940,0,145883940,0,0,145883940,0,145883940
2023-09-19,457,460,457,460,56312,0.0,0,0,0,0,0,0,0,12767,0,12767,0,0,12767,0,12767,0,0,0,0,0,0,0,25909235,0,25909235,0,0,25909235,0,25909235
2023-09-20,458,460,458,460,139346,0.0,0,0,-1712,1712,0,0,0,29880,1712,31592,0,0,31592,0,31592,0,0,-3475360,3475360,0,0,0,60651400,3475360,64126760,0,0,64126760,0,64126760
2023-09-21,459,462,459,461,374147,0.21739130434782608,0,0,0,0,0,0,0,84825,0,84825,0,0,84825,0,84825,0,0,0,0,0,0,0,172629655,0,172629655,0,0,172629655,0,172629655
2023-09-22,462,462,462,462,120785,0.21691973969631237,0,0,0,0,0,0,0,27384,0,27384,0,0,27384,0,27384,0,0,0,0,0,0,0,55863360,0,55863360,0,0,55863360,0,55863360
2023-09-25,462,463,462,462,92582,0.0,-3084,0,3084,0,0,0,0,20990,0,20990,3084,0,17906,0,20990,-6297520,0,6297520,0,0,0,0,42841100,0,42841100,6297520,0,36543580,0,42841100
2023-09-26,337,337,331,333,588772,-27.92207792207792,0,0,0,0,0,0,0,133484,0,133484,0,0,133484,0,133484,0,0,0,0,0,0,0,199627582,0,199627582,0,0,199627582,0,199627582
2023-09-27,333,334,333,334,425175,0.3003003003003003,32214,0,-32214,0,0,32214,0,64180,0,96394,0,0,96394,0,96394,47498480,0,-47498480,0,0,47498480,0,94489133,0,141987613,0,0,141987613,0,141987613
2023-10-04,339,339,334,335,346760,0.29940119760479045,5,0,-5,0,0,5,0,78611,0,78616,0,0,78616,0,78616,7390,0,-7390,0,0,7390,0,116092158,0,116099548,0,0,116099548,0,116099548
2023-10-05,335,335,332,335,758072,0.0,149948,0,-150548,600,0,149948,0,21319,600,171867,0,0,171867,0,171867,221767948,0,-222655948,888000,0,221767948,0,31524028,888000,254179976,0,0,254179976,0,254179976
2023-10-06,336,336,332,335,216848,0.0,0,0,600,-600,0,0,0,49163,0,49163,0,0,48563,600,49163,0,0,888000,-888000,0,0,0,72729177,0,72729177,0,0,71841177,888000,72729177
2023-10-10,339,339,333,336,122660,0.2985074626865672,0,0,-1,1,0,0,0,27808,1,27809,0,0,27809,0,27809,0,0,-1471,1471,0,0,0,41293735,1471,41295206,0,0,41295206,0,41295206
2023-10-11,336,336,331,336,72712,0.0,0,0,0,0,0,0,0,16485,0,16485,0,0,16485,0,16485,0,0,0,0,0,0,0,24442733,0,24442733,0,0,24442733,0,24442733
2023-10-12,337,337,332,335,188301,-0.2976190476190476,0,0,0,0,0,0,0,42691,0,42691,0,0,42691,0,42691,0,0,0,0,0,0,0,62972424,0,62972424,0,0,62972424,0,62972424
2023-10-13,332,336,332,335,119118,0.0,0,0,0,0,0,0,0,27006,0,27006,0,0,27006,0,27006,0,0,0,0,0,0,0,39959084,0,39959084,0,0,39959084,0,39959084
2023-10-16,335,336,335,336,14141,0.2985074626865672,0,0,0,0,0,0,0,3206,0,3206,0,0,3206,0,3206,0,0,0,0,0,0,0,4770587,0,4770587,0,0,4770587,0,4770587
2023-10-17,337,337,334,336,20946,0.0,0,0,0,0,0,0,0,4749,0,4749,0,0,4749,0,4749,0,0,0,0,0,0,0,7041305,0,7041305,0,0,7041305,0,7041305
2023-10-18,337,337,335,337,675992,0.2976190476190476,92004,0,-92004,0,0,92004,0,61254,0,153258,0,0,153258,0,153258,136717944,0,-136717944,0,0,136717944,0,91053639,0,227771583,0,0,227771583,0,227771583
2023-10-19,338,338,337,337,65328,0.0,0,0,0,0,0,0,0,14811,0,14811,0,0,14811,0,14811,0,0,0,0,0,0,0,22068994,0,22068994,0,0,22068994,0,22068994
2023-10-20,335,337,335,337,537523,0.0,30767,-12500,-18267,0,0,30767,0,91098,0,121865,0,12500,109365,0,121865,45719762,-18619677,-27100085,0,0,45719762,0,135567805,0,181287567,0,18619677,162667890,0,181287567
2023-10-23,338,338,338,338,277859,0.2967359050445104,0,0,0,0,0,0,0,62995,0,62995,0,0,62995,0,62995,0,0,0,0,0,0,0,93930029,0,93930029,0,0,93930029,0,93930029
2023-10-24,337,338,337,338,393139,0.0,-670,0,670,0,0,0,0,89131,0,89131,670,0,88461,0,89131,-998970,0,998970,0,0,0,0,132870644,0,132870644,998970,0,131871674,0,132870644
2023-10-25,337,339,337,338,533893,0.0,-69506,0,69506,0,0,0,0,121042,0,121042,69506,0,51536,0,121042,-103635066,0,103635066,0,0,0,0,180628609,0,180628609,103635066,0,76993543,0,180628609
2023-10-26,338,339,338,339,452236,0.2958579881656805,0,0,0,0,0,0,0,102529,0,102529,0,0,102529,0,102529,0,0,0,0,0,0,0,153241676,0,153241676,0,0,153241676,0,153241676
2023-10-27,339,340,339,340,579157,0.2949852507374631,-3353,0,9353,-6000,0,0,0,131304,0,131304,3353,0,121951,6000,131304,-5026148,0,14026148,-9000000,0,0,0,196883526,0,196883526,5026148,0,182857378,9000000,196883526
2023-10-30,339,340,339,340,267674,0.0,0,0,0,0,0,0,0,60686,0,60686,0,0,60686,0,60686,0,0,0,0,0,0,0,91112153,0,91112153,0,0,91112153,0,91112153
2023-10-31,337,340,337,340,4071,0.0,0,0,0,0,0,0,0,923,0,923,0,0,923,0,923,0,0,0,0,0,0,0,1385178,0,1385178,0,0,1385178,0,1385178
2023-11-01,339,340,339,339,26508,-0.29411764705882354,0,0,0,0,0,0,0,6010,0,6010,0,0,6010,0,6010,0,0,0,0,0,0,0,9026034,0,9026034,0,0,9026034,0,9026034
2023-11-02,338,341,338,340,94325,0.2949852507374631,0,0,0,0,0,0,0,21385,0,21385,0,0,21385,0,21385,0,0,0,0,0,0,0,32115893,0,32115893,0,0,32115893,0,32115893
2023-11-03,340,340,338,339,914303,-0.29411764705882354,0,0,0,0,0,0,0,207287,0,207287,0,0,207287,0,207287,0,0,0,0,0,0,0,310636984,0,310636984,0,0,310636984,0,310636984
2023-11-06,338,338,336,336,325879,-0.8849557522123894,0,0,0,0,0,0,0,73882,0,73882,0,0,73882,0,73882,0,0,0,0,0,0,0,109947497,0,109947497,0,0,109947497,0,109947497
2023-11-07,338,338,336,337,122272,0.2976190476190476,0,0,0,0,0,0,0,27721,0,27721,0,0,27721,0,27721,0,0,0,0,0,0,0,41256067,0,41256067,0,0,41256067,0,41256067
2023-11-08,337,337,336,337,169551,0.0,0,0,0,0,0,0,0,38440,0,38440,0,0,38440,0,38440,0,0,0,0,0,0,0,57047262,0,57047262,0,0,57047262,0,57047262
2023-11-09,337,337,337,337,42321,0.0,0,0,0,0,0,0,0,9595,0,9595,0,0,9595,0,9595,0,0,0,0,0,0,0,14278161,0,14278161,0,0,14278161,0,14278161
2023-11-10,340,340,336,337,12222,0.0,0,0,0,0,0,0,0,2771,0,2771,0,0,2771,0,2771,0,0,0,0,0,0,0,4126819,0,4126819,0,0,4126819,0,4126819
2023-11-13,336,338,336,338,140232,0.2967359050445104,-24060,0,24060,0,0,0,0,31793,0,31793,24060,0,7733,0,31793,-35903390,0,35903390,0,0,0,0,47462512,0,47462512,35903390,0,11559122,0,47462512
2023-11-14,338,340,338,340,48011,0.591715976331361,-1182,0,1182,0,0,0,0,10885,0,10885,1182,0,9703,0,10885,-1767090,0,1767090,0,0,0,0,16318465,0,16318465,1767090,0,14551375,0,16318465
2023-11-15,339,339,334,336,191539,-1.1764705882352942,0,0,0,0,0,0,0,43425,0,43425,0,0,43425,0,43425,0,0,0,0,0,0,0,64400505,0,64400505,0,0,64400505,0,64400505
2023-11-16,334,335,334,334,264017,-0.5952380952380952,-463,0,463,0,0,0,0,59857,0,59857,463,0,59394,0,59857,-687092,0,687092,0,0,0,0,88562203,0,88562203,687092,0,87875111,0,88562203
2023-11-17,334,334,332,334,60481,0.0,-857,0,857,0,0,0,0,13712,0,13712,857,0,12855,0,13712,-1265789,0,1265789,0,0,0,0,20199735,0,20199735,1265789,0,18933946,0,20199735
2023-11-20,334,334,333,333,114786,-0.29940119760479045,-981,0,981,0,0,0,0,26024,0,26024,981,0,25043,0,26024,-1448937,0,1448937,0,0,0,0,38349250,0,38349250,1448937,0,36900313,0,38349250
2023-11-21,334,334,331,332,246065,-0.3003003003003003,-235,0,235,0,0,0,0,55787,0,55787,235,0,55552,0,55787,-345450,0,345450,0,0,0,0,81743972,0,81743972,345450,0,81398522,0,81743972
2023-11-22,334,335,332,335,23284,0.9036144578313252,-756,0,756,0,0,0,0,5279,0,5279,756,0,4523,0,5279,-1111955,0,1111955,0,0,0,0,7761525,0,7761525,1111955,0,6649570,0,7761525
2023-11-23,334,337,334,337,61813,0.5970149253731344,-700,0,700,0,0,0,0,14014,0,14014,700,0,13314,0,14014,-1036700,0,1036700,0,0,0,0,20809252,0,20809252,1036700,0,19772552,0,20809252
2023-11-24,339,339,337,338,119925,0.2967359050445104,-676,0,676,0,0,0,0,27189,0,27189,676,0,26513,0,27189,-1007259,0,1007259,0,0,0,0,40557645,0,40557645,1007259,0,39550386,0,40557645
2023-11-27,337,337,336,337,29234,-0.2958579881656805,0,0,0,0,0,0,0,6628,0,6628,0,0,6628,0,6628,0,0,0,0,0,0,0,9877317,0,9877317,0,0,9877317,0,9877317
2023-11-28,331,335,331,335,64212,-0.5934718100890208,0,0,0,0,0,0,0,14558,0,14558,0,0,14558,0,14558,0,0,0,0,0,0,0,21523377,0,21523377,0,0,21523377,0,21523377
2023-11-29,334,334,333,334,100632,-0.2985074626865672,0,0,0,0,0,0,0,22815,0,22815,0,0,22815,0,22815,0,0,0,0,0,0,0,33626604,0,33626604,0,0,33626604,0,33626604
2023-11-30,334,334,333,334,316259,0.0,0,0,0,0,0,0,0,71701,0,71701,0,0,71701,0,71701,0,0,0,0,0,0,0,105635765,0,105635765,0,0,105635765,0,105635765
2023-12-01,334,335,333,334,308020,0.0,-943,0,943,0,0,0,0,69833,0,69833,943,0,68890,0,69833,-1394158,0,1394158,0,0,0,0,102992711,0,102992711,1394158,0,101598553,0,102992711
2023-12-04,334,335,333,335,155833,0.29940119760479045,-738,0,734,4,0,0,0,35326,4,35330,738,0,34592,0,35330,-1091402,0,1085486,5916,0,0,0,52207024,5916,52212940,1091402,0,51121538,0,52212940
2023-12-05,335,337,335,337,380652,0.5970149253731344,3768,0,-3768,0,0,30024,0,56276,0,86300,26256,0,60044,0,86300,5597966,0,-5597966,0,0,44667749,0,83759562,0,128427311,39069783,0,89357528,0,128427311
2023-12-06,336,339,336,337,106194,0.0,-704,0,704,0,0,0,0,24076,0,24076,704,0,23372,0,24076,-1047552,0,1047552,0,0,0,0,35874019,0,35874019,1047552,0,34826467,0,35874019
2023-12-07,338,340,338,340,179489,0.8902077151335311,17567,0,-17567,0,0,18329,0,22364,0,40693,762,0,39931,0,40693,26334692,0,-26334692,0,0,27473526,0,33544730,0,61018256,1138834,0,59879422,0,61018256
2023-12-08,339,339,339,339,149477,-0.29411764705882354,0,0,0,0,0,0,0,33889,0,33889,0,0,33889,0,33889,0,0,0,0,0,0,0,50743870,0,50743870,0,0,50743870,0,50743870
2023-12-11,338,340,338,340,152437,0.2949852507374631,13250,0,-13250,0,0,13743,0,20817,0,34560,493,0,34067,0,34560,19903965,0,-19903965,0,0,20641986,0,31255707,0,51897693,738021,0,51159672,0,51897693
2023-12-12,340,340,340,340,73126,0.0,-1437,0,1437,0,0,0,0,16579,0,16579,1437,0,15142,0,16579,-2158374,0,2158374,0,0,0,0,24884904,0,24884904,2158374,0,22726530,0,24884904
2023-12-13,339,340,337,340,167063,0.0,-1385,0,1385,0,0,0,0,37876,0,37876,1385,0,36491,0,37876,-2078167,0,2078167,0,0,0,0,56839657,0,56839657,2078167,0,54761490,0,56839657
2023-12-14,338,339,338,338,140629,-0.5882352941176471,2,0,-2,0,0,2,0,31881,0,31883,0,0,31883,0,31883,2996,0,-2996,0,0,2996,0,47653580,0,47656576,0,0,47656576,0,47656576
2023-12-15,335,338,335,338,58350,0.0,0,0,0,0,0,0,0,13229,0,13229,0,0,13229,0,13229,0,0,0,0,0,0,0,19640867,0,19640867,0,0,19640867,0,19640867
2023-12-18,338,338,337,338,157801,0.0,-93,0,93,0,0,0,0,35776,0,35776,93,0,35683,0,35776,-138849,0,138849,0,0,0,0,53349045,0,53349045,138849,0,53210196,0,53349045
2023-12-19,340,340,335,340,438924,0.591715976331361,-2840,0,17840,-15000,0,0,0,99511,0,99511,2840,0,81671,15000,99511,-4250016,0,26750016,-22500000,0,0,0,148724902,0,148724902,4250016,0,121974886,22500000,148724902
2023-12-20,340,340,337,340,107134,0.0,-168,0,168,0,0,0,0,24289,0,24289,168,0,24121,0,24289,-252000,0,252000,0,0,0,0,36431438,0,36431438,252000,0,36179438,0,36431438
2023-12-21,339,341,339,340,26438,0.0,-1298,0,1302,-4,0,0,0,5994,0,5994,1298,0,4692,4,5994,-1947032,0,1953032,-6000,0,0,0,8993140,0,8993140,1947032,0,7040108,6000,8993140
2023-12-22,341,346,341,346,1613937,1.7647058823529411,-62781,0,67866,-5085,0,0,0,365905,0,365905,62781,0,298039,5085,365905,-95590463,0,103334918,-7744455,0,0,0,557053981,0,557053981,95590463,0,453719063,7744455,557053981
2023-12-26,347,371,347,370,2564895,6.9364161849710975,32085,0,-32085,0,0,32085,0,549417,0,581502,0,0,581502,0,581502,52362720,0,-52362720,0,0,52362720,0,884822019,0,937184739,0,0,937184739,0,937184739
2023-12-27,370,481,370,481,1675600,30.0,-450435,0,363466,86969,0,0,0,1588631,86969,1675600,450435,0,1225165,0,1675600,-216611727,0,174779638,41832089,0,0,0,710019899,41832089,751851988,216611727,0,535240261,0,751851988
2023-12-28,599,599,357,357,7740814,-25.779625779625782,-302187,0,299674,2513,0,0,0,7737292,3522,7740814,302187,0,7437618,1009,7740814,-180580013,0,179518342,1061671,0,0,0,3601712379,1535379,3603247758,180580013,0,3422194037,473708,3603247758
2024-01-02,385,385,286,294,5045597,-17.647058823529413,-707845,193373,600741,-86269,0,0,200000,4842513,3084,5045597,707845,6627,4241772,89353,5045597,-207575528,55848605,185214201,-33487278,0,0,58400000,1485545293,910986,1544856279,207575528,2551395,1300331092,34398264,1544856279
2024-01-03,270,305,270,289,2423787,-1.7006802721088436,-20000,0,21041,-1041,0,0,0,2423780,7,2423787,20000,0,2402739,1048,2423787,-5780000,0,6092171,-312171,0,0,0,698346236,1989,698348225,5780000,0,692254065,314160,698348225
2024-01-04,283,375,283,375,3490496,29.757785467128027,-85000,0,84972,28,0,0,0,3490468,28,3490496,85000,0,3405496,0,3490496,-30695000,0,30684920,10080,0,0,0,1217205426,10080,1217215506,30695000,0,1186520506,0,1217215506
2024-01-05,331,331,303,303,4146006,-19.2,643,0,-3953,3310,0,643,0,4141903,3460,4146006,0,0,4145856,150,4146006,199330,0,-1240190,1040860,0,199330,0,1304166444,1086760,1305452534,0,0,1305406634,45900,1305452534
2024-01-08,300,319,287,304,1505854,0.33003300330033003,-50443,100000,-50257,700,0,400,100000,1403954,1500,1505854,50843,0,1454211,800,1505854,-15103517,30450000,-15549983,203500,0,115400,30450000,419874671,435500,450875571,15218917,0,435424654,232000,450875571
2024-01-09,293,316,293,300,1525994,-1.3157894736842104,-9600,0,12600,-3000,0,400,0,1525594,0,1525994,10000,0,1512994,3000,1525994,-2952800,0,3894800,-942000,0,117200,0,465672528,0,465789728,3070000,0,461777728,942000,465789728
2024-01-10,297,311,292,297,1145364,-1.0,-10000,-35253,44642,611,0,0,0,1144753,611,1145364,10000,35253,1100111,0,1145364,-3110000,-10752165,13680308,181857,0,0,0,343874390,181857,344056247,3110000,10752165,330194082,0,344056247
2024-01-11,297,297,285,288,1260672,-3.0303030303030303,200,-6627,-1260,7687,0,200,0,1252785,7687,1260672,0,6627,1254045,0,1260672,57000,-1908576,-374741,2226317,0,57000,0,360495558,2226317,362778875,0,1908576,360870299,0,362778875
2024-01-12,299,299,274,274,1385345,-4.861111111111112,0,0,-1100,1100,0,0,0,1384245,1100,1385345,0,0,1385345,0,1385345,0,0,-304800,304800,0,0,0,392114659,304800,392419459,0,0,392419459,0,392419459
2024-01-15,274,274,252,252,1841277,-8.02919708029197,-7600,0,7125,475,0,2400,0,1838172,705,1841277,10000,0,1831047,230,1841277,-2072400,0,1945650,126750,0,627600,0,478407229,184710,479219539,2700000,0,476461579,57960,479219539
2024-01-16,251,251,224,224,2363302,-11.11111111111111,-13815,0,9048,4767,0,0,0,2358535,4767,2363302,13815,0,2349487,0,2363302,-3343230,0,2264796,1078434,0,0,0,549107486,1078434,550185920,3343230,0,546842690,0,550185920
2024-01-17,223,291,208,236,6226043,5.357142857142857,-1500,-100,-1885,3485,0,1000,0,6212023,13020,6226043,2500,100,6213908,9535,6226043,-486500,-29100,-512180,1027780,0,236000,0,1614049100,3488865,1617773965,722500,29100,1614561280,2461085,1617773965
2024-01-18,226,246,226,232,2348430,-1.694915254237288,0,0,6706,-6706,0,0,0,2339321,9109,2348430,0,0,2332615,15815,2348430,0,0,1604202,-1604202,0,0,0,545619227,2097288,547716515,0,0,544015025,3701490,547716515
2024-01-19,229,237,227,236,1338366,1.7241379310344827,0,0,-1000,1000,0,0,0,1337366,1000,1338366,0,0,1338366,0,1338366,0,0,-227000,227000,0,0,0,309344027,227000,309571027,0,0,309571027,0,309571027
2024-01-22,232,232,225,226,1634646,-4.23728813559322,700,0,5305,-6005,0,700,0,1633946,0,1634646,0,0,1628641,6005,1634646,158200,0,1226950,-1385150,0,158200,0,372712023,0,372870223,0,0,371485073,1385150,372870223
2024-01-23,227,235,227,228,643255,0.8849557522123894,0,0,-2475,2475,0,0,0,640780,2475,643255,0,0,643255,0,643255,0,0,-569250,569250,0,0,0,147169502,569250,147738752,0,0,147738752,0,147738752
2024-01-24,232,232,224,225,516250,-1.3157894736842104,0,0,-981,981,0,0,0,515269,981,516250,0,0,516250,0,516250,0,0,-220846,220846,0,0,0,116453624,220846,116674470,0,0,116674470,0,116674470
2024-01-25,223,223,211,213,871754,-5.333333333333334,700,0,-739,39,0,700,0,870987,67,871754,0,0,871726,28,871754,147700,0,-155979,8279,0,147700,0,187513032,14271,187675003,0,0,187669011,5992,187675003
2024-01-26,213,226,211,213,1009018,0.0,-3,0,5307,-5304,0,0,0,1008213,805,1009018,3,0,1002906,6109,1009018,-639,0,1144219,-1143580,0,0,0,218723934,169855,218893789,639,0,217579715,1313435,218893789
2024-01-29,215,217,213,215,429899,0.9389671361502347,0,0,-40,40,0,0,0,429859,40,429899,0,0,429899,0,429899,0,0,-8520,8520,0,0,0,92236200,8520,92244720,0,0,92244720,0,92244720
2024-01-30,214,228,214,226,510311,5.116279069767442,0,0,-110,110,0,0,0,510200,111,510311,0,0,510310,1,510311,0,0,-24160,24160,0,0,0,113454016,24386,113478402,0,0,113478176,226,113478402
2024-01-31,228,239,224,237,767923,4.867256637168142,0,100000,-100001,1,0,0,100000,667922,1,767923,0,0,767923,0,767923,0,23480000,-23480226,226,0,0,23480000,155011979,226,178492205,0,0,178492205,0,178492205
2024-02-01,233,236,226,229,500360,-3.375527426160337,0,0,979,-979,0,0,0,500339,21,500360,0,0,499360,1000,500360,0,0,223107,-223107,0,0,0,114600679,4893,114605572,0,0,114377572,228000,114605572
2024-02-02,228,228,219,220,483710,-3.9301310043668125,300,0,-1445,1145,0,300,0,482244,1166,483710,0,0,483689,21,483710,65700,0,-317787,252087,0,65700,0,107208640,256770,107531110,0,0,107526427,4683,107531110
2024-02-05,220,226,219,221,473974,0.45454545454545453,0,1501,-10562,9061,0,0,1501,462412,10061,473974,0,0,472974,1000,473974,0,331721,-2379133,2047412,0,0,331721,103187884,2273412,105793017,0,0,105567017,226000,105793017
2024-02-06,224,224,215,217,389510,-1.809954751131222,0,3824,-13824,10000,0,0,3824,375686,10000,389510,0,0,389510,0,389510,0,829808,-2999808,2170000,0,0,829808,82366164,2170000,85365972,0,0,85365972,0,85365972
2024-02-07,218,218,213,214,330817,-1.3824884792626728,300,0,-300,0,0,300,0,330517,0,330817,0,0,330817,0,330817,64500,0,-64500,0,0,64500,0,70905483,0,70969983,0,0,70969983,0,70969983
2024-02-08,218,218,211,212,236629,-0.9345794392523363,100,0,-3150,3050,0,100,0,233479,3050,236629,0,0,236629,0,236629,21100,0,-664650,643550,0,21100,0,49632642,643550,50297292,0,0,50297292,0,50297292
2024-02-13,219,219,212,212,199600,0.0,0,0,12907,-12907,0,0,0,199599,1,199600,0,0,186692,12908,199600,0,0,2826637,-2826637,0,0,0,42574589,215,42574804,0,0,39747952,2826852,42574804
2024-02-14,210,217,210,212,550221,0.0,0,71,-71,0,0,0,71,550150,0,550221,0,0,550221,0,550221,0,15052,-15052,0,0,0,15052,117351518,0,117366570,0,0,117366570,0,117366570
2024-02-15,211,216,211,216,289505,1.8867924528301887,0,0,-27,27,0,0,0,289478,27,289505,0,0,289505,0,289505,0,0,-5751,5751,0,0,0,62119887,5751,62125638,0,0,62125638,0,62125638
2024-02-16,214,216,212,216,226707,0.0,0,3971,-3987,16,0,0,3971,222720,16,226707,0,0,226707,0,226707,0,857736,-861147,3411,0,0,857736,47554134,3411,48415281,0,0,48415281,0,48415281
2024-02-19,217,217,212,216,90077,0.0,0,3986,-4036,50,0,0,3986,86041,50,90077,0,0,90077,0,90077,0,860976,-871826,10850,0,0,860976,18471106,10850,19342932,0,0,19342932,0,19342932
2024-02-20,216,275,216,233,4193093,7.87037037037037,-3430,-6008,-11271,20709,0,1100,0,4166971,25022,4193093,4530,6008,4178242,4313,4193093,-851590,-1594267,-2254741,4700598,0,251900,0,1051075417,5817787,1057145104,1103490,1594267,1053330158,1117189,1057145104
2024-02-21,226,265,226,239,2409066,2.575107296137339,1130,-1475,444,-99,0,5073,0,2402292,1701,2409066,3943,1475,2401848,1800,2409066,222811,-390875,195799,-27735,0,1208561,0,596341738,384465,597934764,985750,390875,596145939,412200,597934764
2024-02-22,238,271,238,252,2815468,5.439330543933055,-1500,0,1601,-101,0,4705,0,2810663,100,2815468,6205,0,2809062,201,2815468,-414245,0,442304,-28059,0,1196915,0,730007318,26400,731230633,1611160,0,729565014,54459,731230633
2024-02-23,249,264,249,249,1296870,-1.1904761904761905,5607,-1455,-8779,4627,0,6107,0,1286136,4627,1296870,500,1455,1294915,0,1296870,1415866,-362295,-2224202,1170631,0,1547866,0,326682958,1170631,329401455,132000,362295,328907160,0,329401455
2024-02-26,248,248,232,237,851168,-4.819277108433735,1,1394,-1466,71,0,1,1394,849702,71,851168,0,0,851168,0,851168,248,330378,-347353,16727,0,248,330378,202277311,16727,202624664,0,0,202624664,0,202624664
2024-02-27,237,240,232,237,339893,0.0,0,-100,91,9,0,0,0,339884,9,339893,0,100,339793,0,339893,0,-23600,21473,2127,0,0,0,79975138,2127,79977265,0,23600,79953665,0,79977265
2024-02-28,231,240,231,235,555603,-0.8438818565400843,0,0,-574,574,0,0,0,555029,574,555603,0,0,555603,0,555603,0,0,-135085,135085,0,0,0,130412780,135085,130547865,0,0,130547865,0,130547865
2024-02-29,233,240,233,238,551066,1.276595744680851,0,0,1270,-1270,0,0,0,551055,11,551066,0,0,549785,1281,551066,0,0,303574,-303574,0,0,0,130310839,2585,130313424,0,0,130007265,306159,130313424
2024-03-04,237,237,229,230,563843,-3.361344537815126,0,0,0,0,0,0,0,563843,0,563843,0,0,563843,0,563843,0,0,0,0,0,0,0,130788183,0,130788183,0,0,130788183,0,130788183
2024-03-05,227,241,227,228,1001703,-0.8695652173913043,0,-197747,201712,-3965,0,0,0,1001692,11,1001703,0,197747,799980,3976,1001703,0,-46547140,47451116,-903976,0,0,0,233481718,2552,233484270,0,46547140,186030602,906528,233484270
2024-03-06,228,231,224,224,592211,-1.7543859649122806,0,0,1171,-1171,0,0,0,592187,24,592211,0,0,591016,1195,592211,0,0,266060,-266060,0,0,0,134581005,5400,134586405,0,0,134314945,271460,134586405
2024-03-07,223,224,218,219,454826,-2.232142857142857,0,0,-500,500,0,0,0,454326,500,454826,0,0,454826,0,454826,0,0,-109000,109000,0,0,0,99934486,109000,100043486,0,0,100043486,0,100043486
2024-03-08,220,226,220,225,164440,2.73972602739726,0,0,500,-500,0,0,0,164440,0,164440,0,0,163940,500,164440,0,0,112000,-112000,0,0,0,36792710,0,36792710,0,0,36680710,112000,36792710
2024-03-11,225,238,225,234,392079,4.0,0,0,-4247,4247,0,0,0,387832,4247,392079,0,0,392079,0,392079,0,0,-993798,993798,0,0,0,89513199,993798,90506997,0,0,90506997,0,90506997
2024-03-12,234,236,230,235,234663,0.4273504273504274,0,0,-51,51,0,0,0,234612,51,234663,0,0,234663,0,234663,0,0,-11986,11986,0,0,0,54659404,11986,54671390,0,0,54671390,0,54671390
2024-03-13,237,244,237,238,966197,1.276595744680851,0,0,14247,-14247,0,0,0,966197,0,966197,0,0,951950,14247,966197,0,0,3436268,-3436268,0,0,0,232164580,0,232164580,0,0,228728312,3436268,232164580
2024-03-14,238,241,233,236,407812,-0.8403361344537815,0,0,-8,8,0,0,0,407804,8,407812,0,0,407812,0,407812,0,0,-1864,1864,0,0,0,96977394,1864,96979258,0,0,96979258,0,96979258
2024-03-15,237,240,237,238,259822,0.847457627118644,0,0,-58,58,0,0,0,259764,58,259822,0,0,259822,0,259822,0,0,-13804,13804,0,0,0,61981823,13804,61995627,0,0,61995627,0,61995627
2024-03-18,241,241,237,238,325201,0.0,0,0,-15,15,0,0,0,325186,15,325201,0,0,325201,0,325201,0,0,-3615,3615,0,0,0,77627376,3615,77630991,0,0,77630991,0,77630991
2024-03-19,238,241,237,239,492308,0.42016806722689076,0,0,-14500,14500,0,0,0,477808,14500,492308,0,0,492308,0,492308,0,0,-3480000,3480000,0,0,0,114332087,3480000,117812087,0,0,117812087,0,117812087
2024-03-20,240,242,239,239,541167,0.0,0,80000,-80220,220,0,0,80000,460647,520,541167,0,0,540867,300,541167,0,19210000,-19262580,52580,0,0,19210000,111033544,124580,130368124,0,0,130296124,72000,130368124
2024-03-21,248,275,248,254,1561398,6.2761506276150625,-4608,-1108,-339,6055,0,1000,0,1554343,6055,1561398,5608,1108,1554682,0,1561398,-1288200,-304700,36819,1556081,0,254000,0,408096509,1556081,409906590,1542200,304700,408059690,0,409906590
2024-03-22,250,250,242,243,809309,-4.330708661417323,2000,0,-20856,18856,0,2000,0,788453,18856,809309,0,0,809309,0,809309,486000,0,-5070283,4584283,0,486000,0,193266129,4584283,198336412,0,0,198336412,0,198336412
2024-03-25,248,248,242,242,453646,-0.411522633744856,0,0,-1001,1001,0,0,0,452645,1001,453646,0,0,453646,0,453646,0,0,-248242,248242,0,0,0,111363847,248242,111612089,0,0,111612089,0,111612089
2024-03-26,242,244,240,243,391007,0.4132231404958678,0,0,998,-998,0,0,0,391005,2,391007,0,0,390007,1000,391007,0,0,240516,-240516,0,0,0,94754835,484,94755319,0,0,94514319,241000,94755319
2024-03-27,242,247,242,243,614041,0.0,0,14843,-14643,-200,0,0,14843,598848,350,614041,0,0,613491,550,614041,0,3606849,-3558799,-48050,0,0,3606849,146814451,86450,150507750,0,0,150373250,134500,150507750
2024-03-28,245,245,241,244,274800,0.411522633744856,0,0,-11,11,0,0,0,274789,11,274800,0,0,274800,0,274800,0,0,-2673,2673,0,0,0,66652866,2673,66655539,0,0,66655539,0,66655539
2024-03-29,245,271,245,252,970933,3.278688524590164,500,0,-12637,12137,0,2500,0,956296,12137,970933,2000,0,968933,0,970933,122000,0,-3127664,3005664,0,630000,0,245710248,3005664,249345912,508000,0,248837912,0,249345912
2024-04-01,327,327,327,327,2883376,29.761904761904763,900,-379051,390392,-12241,0,900,81000,2800176,1300,2883376,0,460051,2409784,13541,2883376,294300,-123949677,127658184,-4002807,0,294300,26487000,915657552,425100,942863952,0,150436677,787999368,4427907,942863952
2024-04-02,380,425,311,315,97449716,-3.669724770642202,-28519,-219951,-144447,392917,0,20129,1566346,95328877,534364,97449716,48648,1786297,95473324,141447,97449716,-11084437,-44697667,-93309850,149091954,0,8168025,642952497,37585117498,205680587,38441918607,19252462,687650164,37678427348,56588633,38441918607
2024-04-03,325,370,291,301,36317976,-4.444444444444445,-872000,-76554,1282739,-334185,0,0,265633,35375503,676840,36317976,872000,342187,34092764,1011025,36317976,-287792135,-27916039,432562241,-116854067,0,0,90099631,11675855954,221402048,11987357633,287792135,118015670,11243293713,338256115,11987357633
2024-04-04,301,339,281,289,23322575,-3.9867109634551494,-128000,100000,90204,-62204,0,0,195944,22851327,275304,23322575,128000,95944,22761123,337508,23322575,-42505406,28480330,31698985,-17673909,0,0,57918188,7034440220,85924755,7178283163,42505406,29437858,7002741235,103598664,7178283163
2024-04-05,308,325,285,291,11773384,0.6920415224913495,0,-23446,13071,10375,0,0,0,11602775,170609,11773384,0,23446,11589704,160234,11773384,0,-7221368,4321725,2899643,0,0,0,3470267068,50866214,3521133282,0,7221368,3465945343,47966571,3521133282
2024-04-08,289,301,282,287,5215997,-1.3745704467353952,0,-11657,26291,-14634,0,0,0,5152687,63310,5215997,0,11657,5126396,77944,5215997,0,-3343945,7827486,-4483541,0,0,0,1492817713,18525780,1511343493,0,3343945,1484990227,23009321,1511343493
2024-04-09,286,286,273,277,3705941,-3.484320557491289,0,25170,-33911,8741,0,0,25170,3613267,67504,3705941,0,0,3647178,58763,3705941,0,6959756,-9329611,2369855,0,0,6959756,1001401475,18710873,1027072104,0,0,1010731086,16341018,1027072104
2024-04-11,282,284,269,278,1931229,0.36101083032490977,0,-61584,60412,1172,0,0,109,1909310,21810,1931229,0,61693,1848898,20638,1931229,0,-16652348,16438116,214232,0,0,29975,525178145,5972318,531180438,0,16682323,508740029,5758086,531180438
2024-04-12,278,280,267,277,1364626,-0.3597122302158274,0,0,9951,-9951,0,0,0,1355721,8905,1364626,0,0,1345770,18856,1364626,0,0,2781139,-2781139,0,0,0,369586357,2396295,371982652,0,0,366805218,5177434,371982652
2024-04-15,284,292,253,262,7386116,-5.415162454873646,0,0,-78340,78340,0,0,0,7258154,127962,7386116,0,0,7336494,49622,7386116,0,0,-20418126,20418126,0,0,0,1971993389,33602242,2005595631,0,0,1992411515,13184116,2005595631
2024-04-16,260,266,253,255,2023375,-2.6717557251908395,0,-20000,25551,-5551,0,0,0,1977257,46118,2023375,0,20000,1951706,51669,2023375,0,-5140000,6629179,-1489179,0,0,0,511068161,11944465,523012626,0,5140000,504438982,13433644,523012626
2024-04-17,253,258,247,255,1332943,0.0,0,0,-33688,33688,0,0,0,1295154,37789,1332943,0,0,1328842,4101,1332943,0,0,-8490201,8490201,0,0,0,326347440,9521722,335869162,0,0,334837641,1031521,335869162
2024-04-18,255,255,246,251,1301678,-1.5686274509803921,0,0,-86465,86465,0,0,0,1214334,87344,1301678,0,0,1300799,879,1301678,0,0,-21621777,21621777,0,0,0,303361657,21841527,325203184,0,0,324983434,219750,325203184
2024-04-19,255,283,247,253,9521511,0.796812749003984,0,0,124064,-124064,0,0,5016,9212210,304285,9521511,0,5016,9088146,428349,9521511,0,15048,32427226,-32442274,0,0,1404480,2448405366,81143643,2530953489,0,1389432,2415978140,113585917,2530953489
2024-04-22,248,250,233,238,2499155,-5.928853754940711,0,77,-72095,72018,0,0,77,2412532,86546,2499155,0,0,2484627,14528,2499155,0,19088,-17365430,17346342,0,0,19088,577092947,20843196,597955231,0,0,594458377,3496854,597955231
2024-04-23,234,238,231,233,1070779,-2.100840336134454,0,-8510,-23576,32086,0,0,0,1035599,35180,1070779,0,8510,1059175,3094,1070779,0,-1982830,-5503551,7486381,0,0,0,242090743,8211649,250302392,0,1982830,247594294,725268,250302392
2024-04-24,232,239,232,238,850973,2.1459227467811157,0,-2437,12288,-9851,0,0,6001,844796,176,850973,0,8438,832508,10027,850973,0,-580009,2911998,-2331989,0,0,1428235,199040494,41763,200510492,0,2008244,196128496,2373752,200510492
2024-04-25,236,242,233,233,516536,-2.100840336134454,0,6000,35967,-41967,0,0,6000,510177,359,516536,0,0,474210,42326,516536,0,1404000,8481821,-9885821,0,0,1404000,120311439,85544,121800983,0,0,111829618,9971365,121800983
2024-04-26,233,238,232,232,600450,-0.4291845493562232,0,-2144,5961,-3817,0,0,1,600396,53,600450,0,2145,594435,3870,600450,0,-499551,1389038,-889487,0,0,234,139982624,12403,139995261,0,499785,138593586,901890,139995261
2024-04-29,235,235,229,233,359042,0.43103448275862066,0,-2163,-7704,9867,0,0,1,349156,9885,359042,0,2164,356860,18,359042,0,-499652,-1779553,2279205,0,0,232,80707885,2283435,82991552,0,499884,82487438,4230,82991552
2024-04-30,233,235,230,230,547101,-1.2875536480686696,0,-2073,-20942,23015,0,0,100,518165,28836,547101,0,2173,539107,5821,547101,0,-476690,-4797517,5274207,0,0,23100,119804229,6637148,126464477,0,499790,124601746,1362941,126464477
2024-05-02,227,229,222,225,1031918,-2.1739130434782608,0,-1744,9851,-8107,0,0,0,989386,42532,1031918,0,1744,979535,50639,1031918,0,-390656,2291190,-1900534,0,0,0,222179678,9505615,231685293,0,390656,219888488,11406149,231685293
2024-05-03,225,232,223,226,665392,0.4444444444444444,0,0,14231,-14231,0,0,0,618476,46916,665392,0,0,604245,61147,665392,0,0,3269361,-3269361,0,0,0,140005177,10682401,150687578,0,0,136735816,13951762,150687578
2024-05-07,226,229,219,223,650778,-1.3274336283185841,0,0,18342,-18342,0,0,0,630383,20395,650778,0,0,612041,38737,650778,0,0,4169259,-4169259,0,0,0,140288387,4548085,144836472,0,0,136119128,8717344,144836472
2024-05-08,224,224,218,221,600824,-0.8968609865470852,0,0,-20182,20182,0,0,0,580581,20243,600824,0,0,600763,61,600824,0,0,-4427832,4427832,0,0,0,127182170,4441191,131623361,0,0,131610002,13359,131623361
2024-05-09,221,221,215,215,725007,-2.7149321266968327,0,0,-30526,30526,0,0,0,684940,40067,725007,0,0,715466,9541,725007,0,0,-6581089,6581089,0,0,0,148298468,8674338,156972806,0,0,154879557,2093249,156972806
2024-05-10,215,220,215,219,485273,1.8604651162790697,0,0,-99978,99978,0,0,0,384147,101126,485273,0,0,484125,1148,485273,0,0,-21685382,21685382,0,0,0,83230884,21933408,105164292,0,0,104916266,248026,105164292
2024-05-13,220,220,214,216,435612,-1.36986301369863,0,0,111207,-111207,0,0,0,435151,461,435612,0,0,323944,111668,435612,0,0,23936554,-23936554,0,0,0,93673552,99086,93772638,0,0,69736998,24035640,93772638
2024-05-14,216,218,211,214,364069,-0.9259259259259258,0,0,223,-223,0,0,0,362326,1743,364069,0,0,362103,1966,364069,0,0,44682,-44682,0,0,0,77185879,374344,77560223,0,0,77141197,419026,77560223
2024-05-16,214,252,211,228,4938348,6.5420560747663545,0,-78831,138750,-59919,0,0,1169,4283575,653604,4938348,0,80000,4144825,713523,4938348,0,-17604016,33295337,-15691321,0,0,264763,985852777,149458684,1135576224,0,17868779,952557440,165150005,1135576224
2024-05-17,227,240,220,233,1654675,2.1929824561403506,0,0,-141038,141038,0,0,0,1369683,284992,1654675,0,0,1510721,143954,1654675,0,0,-31320699,31320699,0,0,0,312752922,64645836,377398758,0,0,344073621,33325137,377398758
2024-05-20,239,249,233,244,2154302,4.721030042918455,0,-1169,-80554,81723,0,0,0,1760757,393545,2154302,0,1169,1841311,311822,2154302,0,-283898,-20601379,20885277,0,0,0,426671086,95850310,522521396,0,283898,447272465,74965033,522521396
2024-05-21,235,248,233,242,864354,-0.819672131147541,0,517,99336,-99853,0,0,517,809759,54078,864354,0,0,710423,153931,864354,0,125222,23711467,-23836689,0,0,125222,193962377,13063296,207150895,0,0,170250910,36899985,207150895
2024-05-22,242,248,236,241,837518,-0.4132231404958678,0,81,-14627,14546,0,0,81,743527,93910,837518,0,0,758154,79364,837518,0,19707,-3301691,3281984,0,0,19707,179263517,22536344,201819568,0,0,182565208,19254360,201819568
2024-05-23,243,245,236,239,588124,-0.8298755186721992,0,0,18876,-18876,0,0,0,500404,87720,588124,0,0,481528,106596,588124,0,0,4439754,-4439754,0,0,0,119677246,21030113,140707359,0,0,115237492,25469867,140707359
2024-05-24,241,245,235,237,419739,-0.8368200836820083,0,0,-31567,31567,0,0,0,384934,34805,419739,0,0,416501,3238,419739,0,0,-7433602,7433602,0,0,0,91258536,8204778,99463314,0,0,98692138,771176,99463314
2024-05-27,240,243,236,237,468967,0.0,0,733,23130,-23863,0,0,733,468209,25,468967,0,0,445079,23888,468967,0,174608,5530388,-5704996,0,0,174608,112046907,6050,112227565,0,0,106516519,5711046,112227565
2024-05-28,236,240,236,239,341546,0.8438818565400843,0,0,-8727,8727,0,0,0,327217,14329,341546,0,0,335944,5602,341546,0,0,-2071424,2071424,0,0,0,77968350,3410302,81378652,0,0,80039774,1338878,81378652
2024-05-29,242,242,237,239,460749,0.0,0,351,37252,-37603,0,0,351,450991,9407,460749,0,0,413739,47010,460749,0,83748,8926980,-9010728,0,0,83748,107660639,2229479,109973866,0,0,98733659,11240207,109973866
2024-05-30,242,242,236,237,287225,-0.8368200836820083,0,0,4668,-4668,0,0,0,287225,0,287225,0,0,282557,4668,287225,0,0,1101648,-1101648,0,0,0,68181933,0,68181933,0,0,67080285,1101648,68181933
2024-05-31,235,239,230,234,662923,-1.2658227848101267,0,349,2193,-2542,0,0,349,615283,47291,662923,0,0,613090,49833,662923,0,81322,498917,-580239,0,0,81322,142876037,11062618,154019977,0,0,142377120,11642857,154019977
2024-06-03,234,273,232,256,8912567,9.401709401709402,0,-511,-381666,382177,0,0,0,7548042,1364525,8912567,0,511,7929708,982348,8912567,0,-135926,-90310554,90446480,0,0,0,1922586600,344640426,2267227026,0,135926,2012897154,254193946,2267227026
2024-06-04,249,275,237,242,12597454,-5.46875,0,0,505783,-505783,0,0,0,11440057,1157397,12597454,0,0,10934274,1663180,12597454,0,0,133936992,-133936992,0,0,0,2934153609,294880424,3229034033,0,0,2800216617,428817416,3229034033
2024-06-05,240,247,233,237,1709127,-2.066115702479339,0,0,-176703,176703,0,0,0,1475530,233597,1709127,0,0,1652233,56894,1709127,0,0,-41824633,41824633,0,0,0,349172354,55393439,404565793,0,0,390996987,13568806,404565793
2024-06-07,236,247,230,240,1598814,1.2658227848101267,0,4154,-1422,-2732,0,0,4154,1430876,163784,1598814,0,0,1432298,166516,1598814,0,1003587,-83029,-920558,0,0,1003587,340806282,39024219,380834088,0,0,340889311,39944777,380834088
2024-06-10,237,246,235,240,627473,0.0,0,4282,20637,-24919,0,0,4282,584043,39148,627473,0,0,563406,64067,627473,0,1026366,4935129,-5961495,0,0,1026366,139150041,9289971,149466378,0,0,134214912,15251466,149466378
2024-06-11,237,247,237,242,475296,0.8333333333333334,0,576,20361,-20937,0,0,576,468506,6214,475296,0,0,448145,27151,475296,0,139224,4955291,-5094515,0,0,139224,113531090,1495376,115165690,0,0,108575799,6589891,115165690
2024-06-12,240,243,237,240,314711,-0.8264462809917356,0,217,-18989,18772,0,0,217,292431,22063,314711,0,0,311420,3291,314711,0,52080,-4542040,4489960,0,0,52080,69679360,5275257,75006697,0,0,74221400,785297,75006697
2024-06-13,240,240,237,239,420253,-0.4166666666666667,0,2978,-54937,51959,0,0,2978,365232,52043,420253,0,0,420169,84,420253,0,714110,-13132227,12418117,0,0,714110,86912281,12438277,100064668,0,0,100044508,20160,100064668
2024-06-14,238,243,238,238,714409,-0.41841004184100417,0,2241,-110285,108044,0,0,2241,546649,165519,714409,0,0,656934,57475,714409,0,540377,-26618106,26077729,0,0,540377,131182363,39821514,171544254,0,0,157800469,13743785,171544254
2024-06-17,238,241,238,239,218542,0.42016806722689076,0,4444,552,-4996,0,0,4444,213954,144,218542,0,0,213402,5140,218542,0,1062116,131495,-1193611,0,0,1062116,51062696,34367,52159179,0,0,50931201,1227978,52159179
2024-06-18,239,269,238,244,4541740,2.092050209205021,0,4787,47732,-52519,0,0,4788,3938167,598785,4541740,0,1,3890435,651304,4541740,0,1159528,17274251,-18433779,0,0,1159768,990441754,148838839,1140440361,0,240,973167503,167272618,1140440361
2024-06-19,244,248,239,244,1266886,0.0,0,545,-159091,158546,0,0,545,1086356,179985,1266886,0,0,1245447,21439,1266886,0,132216,-38290478,38158262,0,0,132216,262585752,43403014,306120982,0,0,300876230,5244752,306120982
2024-06-20,244,248,240,246,630981,0.819672131147541,0,2299,-30487,28188,0,0,2300,568517,60164,630981,0,1,599004,31976,630981,0,563256,-7371556,6808300,0,0,563500,139200388,14674868,154438756,0,244,146571944,7866568,154438756
2024-06-21,248,249,237,237,537937,-3.6585365853658534,0,6443,29897,-36340,0,0,6443,524898,6596,537937,0,0,495001,42936,537937,0,1548520,7283741,-8832261,0,0,1548520,127138391,1589815,130276726,0,0,119854650,10422076,130276726
2024-06-24,238,242,237,238,417365,0.42194092827004215,0,240,40560,-40800,0,0,240,417115,10,417365,0,0,376555,40810,417365,0,57364,9738411,-9795775,0,0,57364,99633638,2390,99693392,0,0,89895227,9798165,99693392
2024-06-25,245,245,238,239,354778,0.42016806722689076,0,82,12949,-13031,0,0,82,326664,28032,354778,0,0,313715,41063,354778,0,19680,3211144,-3230824,0,0,19680,78340890,6699897,85060467,0,0,75129746,9930721,85060467
2024-06-26,242,242,236,238,230263,-0.41841004184100417,0,544,19038,-19582,0,0,544,224955,4764,230263,0,0,205917,24346,230263,0,129635,4576435,-4706070,0,0,129635,53758461,1133698,55021794,0,0,49182026,5839768,55021794
2024-06-27,239,240,236,240,346929,0.8403361344537815,0,444,8308,-8752,0,0,444,344474,2011,346929,0,0,336166,10763,346929,0,106249,1986665,-2092914,0,0,106249,82039701,478980,82624930,0,0,80053036,2571894,82624930
2024-06-28,240,246,238,241,571376,0.4166666666666667,0,332,-102132,101800,0,0,332,460229,110815,571376,0,0,562361,9015,571376,0,79779,-24559236,24479457,0,0,79779,111106499,26687811,137874089,0,0,135665735,2208354,137874089
2024-07-01,239,243,239,241,303306,0.0,0,276,-9045,8769,0,0,276,270663,32367,303306,0,0,279708,23598,303306,0,66516,-2216671,2150155,0,0,66516,65130796,7800447,72997759,0,0,67347467,5650292,72997759
2024-07-02,241,247,241,242,540498,0.4149377593360996,0,524,-87130,86606,0,0,524,448488,91486,540498,0,0,535618,4880,540498,0,127442,-21269147,21141705,0,0,127442,109186392,22331289,131645123,0,0,130455539,1189584,131645123
2024-07-03,242,244,237,239,583604,-1.2396694214876034,0,398,5698,-6096,0,0,398,544939,38267,583604,0,0,539241,44363,583604,0,95128,1437094,-1532222,0,0,95128,131023826,9153329,140272283,0,0,129586732,10685551,140272283
2024-07-04,238,239,230,232,592260,-2.928870292887029,0,96,-49967,49871,0,0,96,499795,92369,592260,0,0,549762,42498,592260,0,22616,-11562698,11540082,0,0,22616,117217372,21528567,138768555,0,0,128780070,9988485,138768555
2024-07-05,238,238,222,230,820736,-0.8620689655172413,0,275,30304,-30579,0,0,275,774496,45965,820736,0,0,744192,76544,820736,0,63250,7028705,-7091955,0,0,63250,175814684,10363930,186241864,0,0,168785979,17455885,186241864
2024-07-08,227,230,220,224,543294,-2.608695652173913,0,585,14533,-15118,0,0,585,532003,10706,543294,0,0,517470,25824,543294,0,130877,3243274,-3374151,0,0,130877,118633067,2394549,121158493,0,0,115389793,5768700,121158493
2024-07-09,221,226,220,225,363487,0.4464285714285714,0,194,-50668,50474,0,0,194,305623,57670,363487,0,0,356291,7196,363487,0,43650,-11315320,11271670,0,0,43650,67961922,12873486,80879058,0,0,79277242,1601816,80879058
2024-07-10,221,226,221,226,235246,0.4444444444444444,0,395,-3965,3570,0,0,395,228347,6504,235246,0,0,232312,2934,235246,0,88958,-878092,789134,0,0,88958,51110761,1447538,52647257,0,0,51988853,658404,52647257
2024-07-11,227,229,224,227,144038,0.4424778761061947,0,250,-4900,4650,0,0,250,138111,5677,144038,0,0,143011,1027,144038,0,56670,-1107414,1050744,0,0,56670,31153414,1282624,32492708,0,0,32260828,231880,32492708
2024-07-12,220,227,220,222,166315,-2.2026431718061676,0,439,29994,-30433,0,0,439,163559,2317,166315,0,0,133565,32750,166315,0,97288,6753469,-6850757,0,0,97288,36459622,516105,37073015,0,0,29706153,7366862,37073015
2024-07-15,227,227,221,223,171236,0.45045045045045046,0,291,42432,-42723,0,0,291,168979,1966,171236,0,0,126547,44689,171236,0,64760,9482618,-9547378,0,0,64760,37679877,439148,38183785,0,0,28197259,9986526,38183785
2024-07-16,223,230,221,225,609413,0.8968609865470852,0,25568,-185876,160308,0,0,25568,397148,186697,609413,0,0,583024,26389,609413,0,5702970,-41779394,36076424,0,0,5702970,89342051,41966838,137011859,0,0,131121445,5890414,137011859
2024-07-17,225,229,223,228,228814,1.3333333333333335,0,216,101,-317,0,0,216,217555,11043,228814,0,0,217454,11360,228814,0,49149,32313,-81462,0,0,49149,49188070,2485759,51722978,0,0,49155757,2567221,51722978
2024-07-18,229,229,223,225,226988,-1.3157894736842104,0,325,-16160,15835,0,0,325,172528,54135,226988,0,0,188688,38300,226988,0,73384,-3647256,3573872,0,0,73384,38918834,12197234,51189452,0,0,42566090,8623362,51189452
2024-07-19,223,229,223,226,109574,0.4444444444444444,0,438,20520,-20958,0,0,438,108834,302,109574,0,0,88314,21260,109574,0,98773,4595565,-4694338,0,0,98773,24442139,67950,24608862,0,0,19846574,4762288,24608862
2024-07-22,225,229,225,226,311916,0.0,0,26,32362,-32388,0,0,26,311890,0,311916,0,0,279528,32388,311916,0,5896,7310076,-7315972,0,0,5896,70804790,0,70810686,0,0,63494714,7315972,70810686
2024-07-23,226,228,224,224,181868,-0.8849557522123894,0,521,61257,-61778,0,0,521,177347,4000,181868,0,0,116090,65778,181868,0,117334,13751811,-13869145,0,0,117334,40043831,908000,41069165,0,0,26292020,14777145,41069165
2024-07-24,224,229,222,224,120411,0.0,0,89,-10024,9935,0,0,89,108646,11676,120411,0,0,118670,1741,120411,0,19936,-2230510,2210574,0,0,19936,24397379,2604639,27021954,0,0,26627889,394065,27021954
2024-07-25,224,225,220,223,211354,-0.4464285714285714,0,92,5874,-5966,0,0,92,208530,2732,211354,0,0,202656,8698,211354,0,20451,1301571,-1322022,0,0,20451,46192264,606900,46819615,0,0,44890693,1928922,46819615
2024-07-26,223,223,217,221,303991,-0.8968609865470852,0,11,-20557,20546,0,0,11,279112,24868,303991,0,0,299669,4322,303991,0,2431,-4516333,4513902,0,0,2431,61248372,5462576,66713379,0,0,65764705,948674,66713379
2024-07-29,222,223,218,221,291562,0.0,0,48,3928,-3976,0,0,48,291514,0,291562,0,0,287586,3976,291562,0,10666,868351,-879017,0,0,10666,64173558,0,64184224,0,0,63305207,879017,64184224
2024-07-30,221,224,216,216,161181,-2.262443438914027,0,-24505,54540,-30035,0,0,495,159052,1634,161181,0,25000,104512,31669,161181,0,-5367072,11940670,-6573598,0,0,107928,34825978,357850,35291756,0,5475000,22885308,6931448,35291756
2024-07-31,215,229,212,219,668777,1.3888888888888888,-5308,195,52256,-47143,0,0,195,640493,28089,668777,5308,0,588237,75232,668777,-1141220,42821,11926145,-10827746,0,0,42821,140517206,6048367,146608394,1141220,0,128591061,16876113,146608394
2024-08-01,219,222,213,217,497166,-0.91324200913242,500,193,-11652,10959,0,500,193,481406,15067,497166,0,0,493058,4108,497166,107500,41921,-2496720,2347299,0,107500,41921,103974289,3240657,107364367,0,0,106471009,893358,107364367
2024-08-02,219,222,216,221,419059,1.8433179723502304,0,56,-7049,6993,0,0,56,411921,7082,419059,0,0,418970,89,419059,0,12374,-1536821,1524447,0,0,12374,90395748,1543938,91952060,0,0,91932569,19491,91952060
2024-08-05,221,250,199,208,3212259,-5.88235294117647,0,-10556,190855,-180299,0,0,174,3013059,199026,3212259,0,10730,2822204,379325,3212259,0,-2571024,49449621,-46878597,0,0,36366,689747748,43160162,732944276,0,2607390,640298127,90038759,732944276
2024-08-06,203,220,201,215,665107,3.3653846153846154,0,443,-43971,43528,0,0,443,584589,80075,665107,0,0,628560,36547,665107,0,94491,-8977623,8883132,0,0,94491,123973963,16741105,140809559,0,0,132951586,7857973,140809559
2024-08-07,213,219,209,218,343088,1.3953488372093024,0,254,-2503,2249,0,0,254,332436,10398,343088,0,0,334939,8149,343088,0,55372,-497975,442603,0,0,55372,70867044,2192234,73114650,0,0,71365019,1749631,73114650
2024-08-08,218,222,214,217,189614,-0.45871559633027525,0,170,9636,-9806,0,0,170,174189,15255,189614,0,0,164553,25061,189614,0,36890,2185452,-2222342,0,0,36890,37803618,3270738,41111246,0,0,35618166,5493080,41111246
2024-08-09,215,221,213,220,219854,1.3824884792626728,0,-11030,-1203,12233,0,0,129,203459,16266,219854,0,11159,204662,4033,219854,0,-2415377,-223540,2638917,0,0,28444,44232941,3522153,47783538,0,2443821,44456481,883236,47783538
2024-08-12,220,220,216,218,213347,-0.9090909090909091,0,147,-10393,10246,0,0,147,201534,11666,213347,0,0,211927,1420,213347,0,32046,-2271062,2239016,0,0,32046,43873829,2550504,46456379,0,0,46144891,311488,46456379
2024-08-13,219,228,217,221,498816,1.3761467889908259,0,-8304,-49707,58011,0,0,66,430362,68388,498816,0,8370,480069,10377,498816,0,-1826880,-10890891,12717771,0,0,14520,94456316,15022629,109493465,0,1841400,105347207,2304858,109493465
2024-08-14,219,221,216,218,339015,-1.3574660633484164,0,300,11855,-12155,0,0,300,338664,51,339015,0,0,326809,12206,339015,0,65342,2584820,-2650162,0,0,65342,74019092,11169,74095603,0,0,71434272,2661331,74095603
2024-08-16,215,218,210,216,607966,-0.9174311926605505,500,100188,-34297,-66391,0,1000,100188,487765,19013,607966,500,0,522062,85404,607966,105000,21558661,-7300155,-14363506,0,213000,21558661,103940516,4046271,129758448,108000,0,111240671,18409777,129758448
2024-08-19,215,217,211,212,224811,-1.8518518518518516,0,339,13396,-13735,0,0,339,216463,8009,224811,0,0,203067,21744,224811,0,72131,2890043,-2962174,0,0,72131,46068545,1696007,47836683,0,0,43178502,4658181,47836683
2024-08-20,214,216,211,214,249842,0.9433962264150944,0,-20874,21248,-374,0,0,148,247569,2125,249842,0,21022,226321,2499,249842,0,-4427105,4507528,-80423,0,0,31672,52606894,450539,53089105,0,4458777,48099366,530962,53089105
2024-08-21,214,217,212,217,222865,1.4018691588785046,0,23,-11,-12,0,0,23,219649,3193,222865,0,0,219660,3205,222865,0,4991,4632,-9623,0,0,4991,47136662,679545,47821198,0,0,47132030,689168,47821198
2024-08-22,218,218,212,217,192441,0.0,0,0,-18635,18635,0,0,0,157785,34656,192441,0,0,176420,16021,192441,0,0,-3937357,3937357,0,0,0,33985814,7399502,41385316,0,0,37923171,3462145,41385316
2024-08-23,215,218,215,217,164687,0.0,0,1,136,-137,0,0,1,164686,0,164687,0,0,164550,137,164687,0,217,29492,-29709,0,0,217,35626418,0,35626635,0,0,35596926,29709,35626635
2024-08-26,217,219,216,219,149634,0.9216589861751152,0,389,-8351,7962,0,0,389,139103,10142,149634,0,0,147454,2180,149634,0,84256,-1802436,1718180,0,0,84256,30240109,2190672,32515037,0,0,32042545,472492,32515037
2024-08-27,219,219,213,218,143307,-0.45662100456621,0,85,-642,557,0,0,85,139537,3685,143307,0,0,140179,3128,143307,0,18503,-134517,116014,0,0,18503,30032210,792412,30843125,0,0,30166727,676398,30843125
2024-08-28,218,222,212,218,494449,0.0,0,614,5954,-6568,0,0,614,488133,5702,494449,0,0,482179,12270,494449,0,133797,1267740,-1401537,0,0,133797,105717256,1225930,107076983,0,0,104449516,2627467,107076983
2024-08-29,220,220,212,214,338054,-1.834862385321101,0,554,-18565,18011,0,0,570,300252,37232,338054,0,16,318817,19221,338054,0,118750,-3999476,3880726,0,0,122270,64680925,8005299,72808494,0,3520,68680401,4124573,72808494
2024-08-30,216,218,214,218,79849,1.8691588785046727,0,-333,-4222,4555,0,0,366,74820,4663,79849,0,699,79042,108,79849,0,-71597,-912076,983673,0,0,79387,16136519,1007120,17223026,0,150984,17048595,23447,17223026
2024-09-02,220,222,214,220,207148,0.9174311926605505,0,-93,4969,-4876,0,0,433,204837,1878,207148,0,526,199868,6754,207148,0,-20994,1092778,-1071784,0,0,94726,44772967,409320,45277013,0,115720,43680189,1481104,45277013
2024-09-03,218,223,216,216,78553,-1.8181818181818181,0,143,1933,-2076,0,0,406,76347,1800,78553,0,263,74414,3876,78553,0,30602,435892,-466494,0,0,88988,16637843,392400,17119231,0,58386,16201951,858894,17119231
2024-09-04,218,218,213,217,197162,0.4629629629629629,0,230,16788,-17018,0,0,362,196800,0,197162,0,132,180012,17018,197162,0,48876,3627752,-3676628,0,0,77652,42345991,0,42423643,0,28776,38718239,3676628,42423643
2024-09-05,217,220,214,215,349727,-0.9216589861751152,0,-63032,72278,-9246,0,0,72,348416,1239,349727,0,63104,276138,10485,349727,0,-13552144,15586397,-2034253,0,0,15480,75599770,270082,75885332,0,13567624,60013373,2304335,75885332
2024-09-06,215,217,212,213,171486,-0.9302325581395349,0,-8331,17097,-8766,0,0,403,171083,0,171486,0,8734,153986,8766,171486,0,-1800425,3689558,-1889133,0,0,86152,36639037,0,36725189,0,1886577,32949479,1889133,36725189
2024-09-09,220,220,214,215,208775,0.9389671361502347,0,756,13782,-14538,0,0,789,206729,1257,208775,0,33,192947,15795,208775,0,163177,2990285,-3153462,0,0,170437,44704447,268998,45143882,0,7260,41714162,3422460,45143882
2024-09-10,217,217,212,217,264013,0.9302325581395349,0,374,15483,-15857,0,0,374,258613,5026,264013,0,0,243130,20883,264013,0,80522,3348932,-3429454,0,0,80522,55657515,1077184,56815221,0,0,52308583,4506638,56815221
2024-09-11,214,217,212,215,163533,-0.9216589861751152,0,173,1603,-1776,0,0,173,162678,682,163533,0,0,161075,2458,163533,0,37195,344080,-381275,0,0,37195,34829449,145948,35012592,0,0,34485369,527223,35012592
2024-09-12,215,216,212,215,121010,0.0,0,439,14447,-14886,0,0,439,120571,0,121010,0,0,106124,14886,121010,0,94385,3117698,-3212083,0,0,94385,25910120,0,26004505,0,0,22792422,3212083,26004505
2024-09-13,215,218,212,218,313289,1.3953488372093024,0,674,-835,161,0,0,674,308253,4362,313289,0,0,309088,4201,313289,0,146601,-172125,25524,0,0,146601,66346811,937830,67431242,0,0,66518936,912306,67431242
2024-09-19,218,219,212,216,260927,-0.9174311926605505,0,-7928,22189,-14261,0,0,333,259365,1229,260927,0,8261,237176,15490,260927,0,-1704036,4807735,-3103699,0,0,72079,55720855,264235,56057169,0,1776115,50913120,3367934,56057169
2024-09-20,218,218,214,217,267377,0.4629629629629629,500,193,-683,-10,0,500,193,266684,0,267377,0,0,267367,10,267377,107000,41688,-146508,-2180,0,107000,41688,57548292,0,57696980,0,0,57694800,2180,57696980
2024-09-23,217,230,216,229,984919,5.529953917050691,-1500,1025,12892,-12417,0,0,1025,972029,11865,984919,1500,0,959137,24282,984919,-327000,233459,2924921,-2831380,0,0,233459,217886387,2666010,220785856,327000,0,214961466,5497390,220785856
2024-09-24,230,236,223,234,904460,2.1834061135371177,500,359,24240,-25099,0,500,359,885938,17663,904460,0,0,861698,42762,904460,115500,84006,5641689,-5841195,0,115500,84006,205045522,4070920,209315948,0,0,199403833,9912115,209315948
2024-09-25,234,244,221,234,1108837,0.0,-500,-7,-20614,21121,0,1000,0,1042157,65680,1108837,1500,7,1062771,44559,1108837,-126000,-1652,-4560828,4688480,0,223500,0,239416972,15005070,254645542,349500,1652,243977800,10316590,254645542
2024-09-26,234,235,227,233,889935,-0.4273504273504274,1000,-17469,63042,-46573,0,1000,5,881149,7781,889935,0,17474,818107,54354,889935,231000,-4087751,14645084,-10788333,0,231000,1165,204392959,1788484,206413608,0,4088916,189747875,12576817,206413608
2024-09-27,194,213,188,201,3883989,-13.733905579399142,1000,-362,147484,-148122,0,2000,0,3725479,156510,3883989,1000,362,3577995,304632,3883989,191500,-72038,29804658,-29924120,0,394000,0,739917636,30758008,771069644,202500,72038,710112978,60682128,771069644
2024-09-30,186,201,186,191,1332147,-4.975124378109453,2200,-364,71446,-73282,0,2200,0,1300472,29475,1332147,0,364,1229026,102757,1332147,418600,-69160,13927163,-14276603,0,418600,0,249721715,5661621,255801936,0,69160,235794552,19938224,255801936
2024-10-02,195,195,186,192,973758,0.5235602094240838,0,0,72183,-72183,0,0,0,968404,5354,973758,0,0,896221,77537,973758,0,0,13933019,-13933019,0,0,0,184364497,1004130,185368627,0,0,170431478,14937149,185368627
2024-10-04,194,194,190,191,371461,-0.5208333333333333,0,-32524,32976,-452,0,0,2,371038,421,371461,0,32526,338062,873,371461,0,-6232393,6318868,-86475,0,0,384,71270047,81479,71351910,0,6232777,64951179,167954,71351910
2024-10-07,192,196,188,192,582051,0.5235602094240838,0,0,12542,-12542,0,0,0,580561,1490,582051,0,0,568019,14032,582051,0,0,2461464,-2461464,0,0,0,111464736,288740,111753476,0,0,109003272,2750204,111753476
2024-10-08,192,193,190,192,301714,0.0,0,0,323,-323,0,0,0,301714,0,301714,0,0,301391,323,301714,0,0,61616,-61616,0,0,0,57556682,0,57556682,0,0,57495066,61616,57556682
2024-10-10,187,192,187,188,516117,-2.083333333333333,0,0,-723,723,0,0,0,515016,1101,516117,0,0,515739,378,516117,0,0,-136825,136825,0,0,0,97187492,207889,97395381,0,0,97324317,71064,97395381
2024-10-11,190,190,187,189,380325,0.5319148936170213,0,9772,-9840,68,0,0,9772,367915,2638,380325,0,0,377755,2570,380325,0,1856008,-1871387,15379,0,0,1856008,69216594,498582,71571184,0,0,71087981,483203,71571184
2024-10-14,188,188,182,187,473844,-1.0582010582010581,0,3202,-2891,-311,0,0,4702,464829,4313,473844,0,1500,467720,4624,473844,0,603276,-540846,-62430,0,0,879276,86229431,796331,87905038,0,276000,86770277,858761,87905038
2024-10-15,188,188,175,178,699399,-4.81283422459893,0,0,-12203,12203,0,0,0,683408,15991,699399,0,0,695611,3788,699399,0,0,-2180420,2180420,0,0,0,123856486,2858945,126715431,0,0,126036906,678525,126715431
2024-10-16,182,183,166,171,1021024,-3.932584269662921,2207,-8000,-4246,10039,0,2207,0,997847,20970,1021024,0,8000,1002093,10931,1021024,401674,-1456000,-519094,1573420,0,401674,0,171165938,3538115,175105727,0,1456000,171685032,1964695,175105727
2024-10-17,169,173,160,164,1501471,-4.093567251461988,0,1,-233828,233827,0,0,1,1231158,270312,1501471,0,0,1464986,36485,1501471,0,160,-37981035,37980875,0,0,160,201483438,44060173,245543771,0,0,239464473,6079298,245543771
2024-10-18,164,170,158,165,1293178,0.6097560975609756,0,-49999,30145,19854,0,0,1,1167307,125870,1293178,0,50000,1137162,106016,1293178,0,-8105027,5007827,3097200,0,0,166,190988662,20498545,211487373,0,8105193,185980835,17401345,211487373
2024-10-21,167,169,154,158,1430012,-4.242424242424243,0,-46841,51425,-4584,0,0,3159,1317520,109333,1430012,0,50000,1266095,113917,1430012,0,-7300051,8490452,-1190401,0,0,500521,210199212,17215172,227914905,0,7800572,201708760,18405573,227914905
2024-10-22,159,159,145,149,1763042,-5.69620253164557,0,538,-12244,11706,0,0,538,1663501,99003,1763042,0,0,1675745,87297,1763042,0,80700,-1595334,1514634,0,0,80700,248668479,14749877,263499056,0,0,250263813,13235243,263499056
2024-10-23,149,152,148,148,554842,-0.6711409395973155,0,1,7845,-7846,0,0,1,554551,290,554842,0,0,546706,8136,554842,0,148,1173368,-1173516,0,0,148,82957708,43104,83000960,0,0,81784340,1216620,83000960
2024-10-24,149,149,145,147,463408,-0.6756756756756757,0,-536,2560,-2024,0,0,1,459982,3425,463408,0,537,457422,5449,463408,0,-78255,377177,-298922,0,0,147,67436871,503424,67940442,0,78402,67059694,802346,67940442
2024-10-25,147,150,146,148,385246,0.6802721088435374,0,-3158,2790,368,0,0,0,381775,3471,385246,0,3158,378985,3103,385246,0,-464071,414027,50044,0,0,0,56387493,507995,56895488,0,464071,55973466,457951,56895488
2024-10-28,148,148,144,146,595125,-1.3513513513513513,0,0,-4977,4977,0,0,0,584510,10615,595125,0,0,589487,5638,595125,0,0,-707202,707202,0,0,0,85360878,1539782,86900660,0,0,86068080,832580,86900660
2024-10-29,143,143,133,134,1492975,-8.21917808219178,0,573,163115,-163688,0,0,573,1487188,5214,1492975,0,0,1324073,168902,1492975,0,76782,22726088,-22802870,0,0,76782,204684740,737920,205499442,0,0,181958652,23540790,205499442
2024-10-30,134,134,125,126,1216580,-5.970149253731343,0,4537,-2078,-2459,0,0,4537,1182120,29923,1216580,0,0,1184198,32382,1216580,0,576199,-264588,-311611,0,0,576199,151815515,3892430,156284144,0,0,152080103,4204041,156284144
2024-10-31,121,126,116,121,1960259,-3.968253968253968,0,69427,-105109,35682,0,0,70000,1810749,79510,1960259,0,573,1915858,43828,1960259,0,8330094,-12532011,4201917,0,0,8400000,216652313,9504665,234556978,0,69906,229184324,5302748,234556978
2024-11-01,121,157,120,157,11261714,29.75206611570248,0,109824,-118433,8609,0,0,157288,10737942,366484,11261714,0,47464,10856375,357875,11261714,0,17225841,-17483609,257768,0,0,23964079,1648072352,54275513,1726311944,0,6738238,1665555961,54017745,1726311944
2024-11-04,180,204,163,184,95127061,17.197452229299362,-3106407,-282987,3416454,-27060,0,279,34564,91405926,4942614,96383383,3106686,317551,87989472,4969674,96383383,-633693377,-54931707,705089405,-16464321,0,54405,6253025,17068083788,912494039,17986885257,633747782,61184732,16362994383,928958360,17986885257
